,season,league_name,team,goals,goals_against,points,matches,dif_goals,pos,goals_diff,tot_teams,position,quart,quartile,weighed_rating,points_per_match
113,2008/2009,England Premier League,Manchester United,68,24,90.0,38,44,1,44,20,1,0.05,1.0,82.8854679802956,2.3684210526315788
114,2008/2009,England Premier League,Liverpool,77,27,86.0,38,50,2,50,20,2,0.1,1.0,81.50478468899522,2.263157894736842
115,2008/2009,England Premier League,Chelsea,68,24,83.0,38,44,3,44,20,3,0.15,1.0,83.68779904306221,2.1842105263157894
116,2008/2009,England Premier League,Arsenal,68,37,72.0,38,31,4,31,20,4,0.2,1.0,80.10167464114834,1.894736842105263
117,2008/2009,England Premier League,Everton,55,37,63.0,38,18,5,18,20,5,0.25,1.0,78.06698564593302,1.6578947368421053
118,2008/2009,England Premier League,Aston Villa,54,48,62.0,38,6,6,6,20,6,0.3,2.0,79.45555555555556,1.631578947368421
119,2008/2009,England Premier League,Fulham,39,34,53.0,38,5,7,5,20,7,0.35,2.0,74.74162679425837,1.394736842105263
120,2008/2009,England Premier League,Tottenham Hotspur,45,45,51.0,38,0,8,0,20,8,0.4,2.0,78.2200956937799,1.3421052631578947
121,2008/2009,England Premier League,West Ham United,42,45,51.0,38,-3,9,-3,20,9,0.45,2.0,74.59756097560977,1.3421052631578947
122,2008/2009,England Premier League,Manchester City,58,50,50.0,38,8,10,8,20,10,0.5,2.0,78.16385542168678,1.3157894736842106
123,2008/2009,England Premier League,Wigan Athletic,34,45,45.0,38,-11,11,-11,20,11,0.55,3.0,73.47966507177034,1.1842105263157894
124,2008/2009,England Premier League,Stoke City,38,55,45.0,38,-17,12,-17,20,12,0.6,3.0,70.13397129186603,1.1842105263157894
125,2008/2009,England Premier League,Bolton Wanderers,41,53,41.0,38,-12,13,-12,20,13,0.65,3.0,74.05263157894738,1.0789473684210527
126,2008/2009,England Premier League,Portsmouth,38,57,41.0,38,-19,14,-19,20,14,0.7,3.0,75.7595693779904,1.0789473684210527
127,2008/2009,England Premier League,Blackburn Rovers,40,60,41.0,38,-20,15,-20,20,15,0.75,3.0,75.14963503649635,1.0789473684210527
128,2008/2009,England Premier League,Sunderland,34,54,36.0,38,-20,16,-20,20,16,0.8,4.0,73.76368159203979,0.9473684210526315
129,2008/2009,England Premier League,Hull City,39,64,35.0,38,-25,17,-25,20,17,0.85,4.0,70.95933014354067,0.9210526315789473
130,2008/2009,England Premier League,Newcastle United,40,59,34.0,38,-19,18,-19,20,18,0.9,4.0,75.48564593301437,0.8947368421052632
131,2008/2009,England Premier League,Middlesbrough,28,57,32.0,38,-29,19,-29,20,19,0.95,4.0,73.91507177033492,0.8421052631578947
132,2008/2009,England Premier League,West Bromwich Albion,36,67,32.0,38,-31,20,-31,20,20,1.0,4.0,70.4136690647482,0.8421052631578947
133,2009/2010,England Premier League,Chelsea,103,32,86.0,38,71,1,71,20,1,0.05,1.0,83.64952153110046,2.263157894736842
134,2009/2010,England Premier League,Manchester United,86,28,85.0,38,58,2,58,20,2,0.1,1.0,82.12073170731706,2.236842105263158
135,2009/2010,England Premier League,Arsenal,83,41,75.0,38,42,3,42,20,3,0.15,1.0,80.91028708133972,1.9736842105263157
136,2009/2010,England Premier League,Tottenham Hotspur,67,41,70.0,38,26,4,26,20,4,0.2,1.0,78.7188995215311,1.8421052631578947
137,2009/2010,England Premier League,Manchester City,73,45,67.0,38,28,5,28,20,5,0.25,1.0,80.96237864077672,1.763157894736842
138,2009/2010,England Premier League,Aston Villa,52,39,64.0,38,13,6,13,20,6,0.3,2.0,79.85406698564596,1.6842105263157894
139,2009/2010,England Premier League,Liverpool,61,35,63.0,38,26,7,26,20,7,0.35,2.0,81.82177033492822,1.6578947368421053
140,2009/2010,England Premier League,Everton,60,49,61.0,38,11,8,11,20,8,0.4,2.0,78.81220095693782,1.605263157894737
141,2009/2010,England Premier League,Birmingham City,38,47,50.0,38,-9,9,-9,20,9,0.45,2.0,75.53033980582525,1.3157894736842106
142,2009/2010,England Premier League,Blackburn Rovers,41,55,50.0,38,-14,10,-14,20,10,0.5,2.0,74.3175,1.3157894736842106
143,2009/2010,England Premier League,Stoke City,34,48,47.0,38,-14,11,-14,20,11,0.55,3.0,73.16985645933013,1.236842105263158
144,2009/2010,England Premier League,Fulham,39,46,46.0,38,-7,12,-7,20,12,0.6,3.0,76.08373205741628,1.2105263157894737
145,2009/2010,England Premier League,Sunderland,48,56,44.0,38,-8,13,-8,20,13,0.65,3.0,75.31937799043061,1.1578947368421053
146,2009/2010,England Premier League,Bolton Wanderers,42,67,39.0,38,-25,14,-25,20,14,0.7,3.0,74.41777188328912,1.0263157894736843
147,2009/2010,England Premier League,Wolverhampton Wanderers,32,56,38.0,38,-24,15,-24,20,15,0.75,3.0,70.29066985645933,1.0
148,2009/2010,England Premier League,Wigan Athletic,37,79,36.0,38,-42,16,-42,20,16,0.8,4.0,74.1761658031088,0.9473684210526315
149,2009/2010,England Premier League,West Ham United,47,66,35.0,38,-19,17,-19,20,17,0.85,4.0,74.57296650717704,0.9210526315789473
150,2009/2010,England Premier League,Burnley,42,82,30.0,38,-40,18,-40,20,18,0.9,4.0,72.60311750599521,0.7894736842105263
151,2009/2010,England Premier League,Hull City,34,75,30.0,38,-41,19,-41,20,19,0.95,4.0,70.70913461538464,0.7894736842105263
152,2009/2010,England Premier League,Portsmouth,34,66,28.0,38,-32,20,-32,20,20,1.0,4.0,72.67344497607655,0.7368421052631579
153,2010/2011,England Premier League,Manchester United,78,37,80.0,38,41,1,41,20,1,0.05,1.0,81.84739454094291,2.1052631578947367
154,2010/2011,England Premier League,Chelsea,69,33,71.0,38,36,2,36,20,2,0.1,1.0,83.0263157894737,1.868421052631579
155,2010/2011,England Premier League,Manchester City,60,33,71.0,38,27,3,27,20,3,0.15,1.0,81.20334928229666,1.868421052631579
156,2010/2011,England Premier League,Arsenal,72,43,68.0,38,29,4,29,20,4,0.2,1.0,80.49160671462829,1.7894736842105263
157,2010/2011,England Premier League,Tottenham Hotspur,55,46,62.0,38,9,5,9,20,5,0.25,1.0,79.88157894736841,1.631578947368421
158,2010/2011,England Premier League,Liverpool,59,44,58.0,38,15,6,15,20,6,0.3,2.0,79.53110047846891,1.5263157894736843
159,2010/2011,England Premier League,Everton,51,45,54.0,38,6,7,6,20,7,0.35,2.0,78.08851674641149,1.4210526315789473
160,2010/2011,England Premier League,Fulham,49,43,49.0,38,6,8,6,20,8,0.4,2.0,76.82416267942584,1.2894736842105263
161,2010/2011,England Premier League,Aston Villa,48,59,48.0,38,-11,9,-11,20,9,0.45,2.0,77.8074162679426,1.263157894736842
162,2010/2011,England Premier League,Sunderland,45,56,47.0,38,-11,10,-11,20,10,0.5,2.0,74.94019138755979,1.236842105263158
163,2010/2011,England Premier League,West Bromwich Albion,56,71,47.0,38,-15,11,-15,20,11,0.55,3.0,72.28606356968214,1.236842105263158
164,2010/2011,England Premier League,Newcastle United,56,57,46.0,38,-1,12,-1,20,12,0.6,3.0,74.21531100478468,1.2105263157894737
165,2010/2011,England Premier League,Stoke City,46,48,46.0,38,-2,13,-2,20,13,0.65,3.0,74.23325358851675,1.2105263157894737
166,2010/2011,England Premier League,Bolton Wanderers,52,56,46.0,38,-4,14,-4,20,14,0.7,3.0,75.90104166666666,1.2105263157894737
167,2010/2011,England Premier League,Blackburn Rovers,46,59,43.0,38,-13,15,-13,20,15,0.75,3.0,75.35406698564591,1.131578947368421
168,2010/2011,England Premier League,Wigan Athletic,40,61,42.0,38,-21,16,-21,20,16,0.8,4.0,72.52751196172248,1.105263157894737
169,2010/2011,England Premier League,Wolverhampton Wanderers,46,66,40.0,38,-20,17,-20,20,17,0.85,4.0,71.6842105263158,1.0526315789473684
170,2010/2011,England Premier League,Birmingham City,37,58,39.0,38,-21,18,-21,20,18,0.9,4.0,76.24457831325303,1.0263157894736843
171,2010/2011,England Premier League,Blackpool,55,78,39.0,38,-23,19,-23,20,19,0.95,4.0,71.11510791366906,1.0263157894736843
172,2010/2011,England Premier League,West Ham United,43,70,33.0,38,-27,20,-27,20,20,1.0,4.0,74.01435406698563,0.868421052631579
173,2011/2012,England Premier League,Manchester City,93,29,89.0,38,64,1,64,20,1,0.05,1.0,82.76674641148327,2.3421052631578947
174,2011/2012,England Premier League,Manchester United,89,33,89.0,38,56,2,56,20,2,0.1,1.0,81.73897058823529,2.3421052631578947
175,2011/2012,England Premier League,Arsenal,74,49,70.0,38,25,3,25,20,3,0.15,1.0,80.36842105263158,1.8421052631578947
176,2011/2012,England Premier League,Tottenham Hotspur,66,41,69.0,38,25,4,25,20,4,0.2,1.0,81.02751196172248,1.8157894736842106
177,2011/2012,England Premier League,Newcastle United,56,51,65.0,38,5,5,5,20,5,0.25,1.0,76.32416267942583,1.7105263157894737
178,2011/2012,England Premier League,Chelsea,65,46,64.0,38,19,6,19,20,6,0.3,2.0,82.17105263157895,1.6842105263157894
179,2011/2012,England Premier League,Everton,50,40,56.0,38,10,7,10,20,7,0.35,2.0,77.00956937799042,1.4736842105263157
180,2011/2012,England Premier League,Liverpool,47,40,52.0,38,7,8,7,20,8,0.4,2.0,79.86961722488039,1.368421052631579
181,2011/2012,England Premier League,Fulham,48,51,52.0,38,-3,9,-3,20,9,0.45,2.0,76.48536585365854,1.368421052631579
182,2011/2012,England Premier League,West Bromwich Albion,45,52,47.0,38,-7,10,-7,20,10,0.5,2.0,73.40145985401458,1.236842105263158
183,2011/2012,England Premier League,Swansea City,44,51,47.0,38,-7,11,-7,20,11,0.55,3.0,72.08252427184466,1.236842105263158
184,2011/2012,England Premier League,Norwich City,52,66,47.0,38,-14,12,-14,20,12,0.6,3.0,69.98803827751196,1.236842105263158
185,2011/2012,England Premier League,Sunderland,45,46,45.0,38,-1,13,-1,20,13,0.65,3.0,74.80382775119618,1.1842105263157894
186,2011/2012,England Premier League,Stoke City,36,53,45.0,38,-17,14,-17,20,14,0.7,3.0,75.54066985645935,1.1842105263157894
187,2011/2012,England Premier League,Wigan Athletic,42,62,43.0,38,-20,15,-20,20,15,0.75,3.0,72.3468899521531,1.131578947368421
188,2011/2012,England Premier League,Aston Villa,37,53,38.0,38,-16,16,-16,20,16,0.8,4.0,75.2870813397129,1.0
189,2011/2012,England Premier League,Queens Park Rangers,43,66,37.0,38,-23,17,-23,20,17,0.85,4.0,72.78349282296652,0.9736842105263158
190,2011/2012,England Premier League,Bolton Wanderers,46,77,36.0,38,-31,18,-31,20,18,0.9,4.0,73.78463476070527,0.9473684210526315
191,2011/2012,England Premier League,Blackburn Rovers,48,78,31.0,38,-30,19,-30,20,19,0.95,4.0,73.38157894736842,0.8157894736842105
192,2011/2012,England Premier League,Wolverhampton Wanderers,40,82,25.0,38,-42,20,-42,20,20,1.0,4.0,73.06220095693779,0.6578947368421053
193,2012/2013,England Premier League,Manchester United,86,43,89.0,38,43,1,43,20,1,0.05,1.0,81.04405331510593,2.3421052631578947
194,2012/2013,England Premier League,Manchester City,66,34,78.0,38,32,2,32,20,2,0.1,1.0,82.67813852813853,2.0526315789473686
195,2012/2013,England Premier League,Chelsea,75,39,75.0,38,36,3,36,20,3,0.15,1.0,81.39888642059694,1.9736842105263157
196,2012/2013,England Premier League,Arsenal,72,37,73.0,38,35,4,35,20,4,0.2,1.0,79.89569947596263,1.9210526315789473
197,2012/2013,England Premier League,Tottenham Hotspur,66,46,72.0,38,20,5,20,20,5,0.25,1.0,80.17142287537025,1.894736842105263
198,2012/2013,England Premier League,Everton,55,40,63.0,38,15,6,15,20,6,0.3,2.0,77.76386420596945,1.6578947368421053
199,2012/2013,England Premier League,Liverpool,71,43,61.0,38,28,7,28,20,7,0.35,2.0,79.2240316700843,1.605263157894737
200,2012/2013,England Premier League,West Bromwich Albion,53,57,49.0,38,-4,8,-4,20,8,0.4,2.0,73.73612440191388,1.2894736842105263
201,2012/2013,England Premier League,Swansea City,47,51,46.0,38,-4,9,-4,20,9,0.45,2.0,74.21330029619504,1.2105263157894737
202,2012/2013,England Premier League,West Ham United,45,53,46.0,38,-8,10,-8,20,10,0.5,2.0,72.49373433583959,1.2105263157894737
203,2012/2013,England Premier League,Norwich City,41,58,44.0,38,-17,11,-17,20,11,0.55,3.0,72.82441900205059,1.1578947368421053
204,2012/2013,England Premier League,Fulham,50,60,43.0,38,-10,12,-10,20,12,0.6,3.0,76.36521417179311,1.131578947368421
205,2012/2013,England Premier League,Stoke City,34,45,42.0,38,-11,13,-11,20,13,0.65,3.0,75.10193096377307,1.105263157894737
206,2012/2013,England Premier League,Southampton,49,60,41.0,38,-11,14,-11,20,14,0.7,3.0,72.97392344497608,1.0789473684210527
207,2012/2013,England Premier League,Aston Villa,47,69,41.0,38,-22,15,-22,20,15,0.75,3.0,72.39238437001593,1.0789473684210527
208,2012/2013,England Premier League,Newcastle United,45,68,41.0,38,-23,16,-23,20,16,0.8,4.0,76.85043859649124,1.0789473684210527
209,2012/2013,England Premier League,Sunderland,41,54,39.0,38,-13,17,-13,20,17,0.85,4.0,75.08001822738665,1.0263157894736843
210,2012/2013,England Premier League,Wigan Athletic,47,73,36.0,38,-26,18,-26,20,18,0.9,4.0,73.91544771018454,0.9473684210526315
211,2012/2013,England Premier League,Reading,43,73,28.0,38,-30,19,-30,20,19,0.95,4.0,70.34782410571884,0.7368421052631579
212,2012/2013,England Premier League,Queens Park Rangers,30,60,25.0,38,-30,20,-30,20,20,1.0,4.0,74.7391774891775,0.6578947368421053
213,2013/2014,England Premier League,Manchester City,102,37,86.0,38,65,1,65,20,1,0.05,1.0,82.66622133847015,2.263157894736842
214,2013/2014,England Premier League,Liverpool,101,50,84.0,38,51,2,51,20,2,0.1,1.0,79.49796650717701,2.210526315789474
215,2013/2014,England Premier League,Chelsea,71,27,82.0,38,44,3,44,20,3,0.15,1.0,81.95669286853497,2.1578947368421053
216,2013/2014,England Premier League,Arsenal,68,41,79.0,38,27,4,27,20,4,0.2,1.0,80.47103646619198,2.0789473684210527
217,2013/2014,England Premier League,Everton,61,39,72.0,38,22,5,22,20,5,0.25,1.0,77.51042006239372,1.894736842105263
218,2013/2014,England Premier League,Tottenham Hotspur,55,51,69.0,38,4,6,4,20,6,0.3,2.0,78.55596729161324,1.8157894736842106
219,2013/2014,England Premier League,Manchester United,64,43,64.0,38,21,7,21,20,7,0.35,2.0,80.28450387331965,1.6842105263157894
220,2013/2014,England Premier League,Southampton,54,46,56.0,38,8,8,8,20,8,0.4,2.0,74.59617898050912,1.4736842105263157
221,2013/2014,England Premier League,Stoke City,45,52,50.0,38,-7,9,-7,20,9,0.45,2.0,74.75428447150934,1.3157894736842106
222,2013/2014,England Premier League,Newcastle United,43,59,49.0,38,-16,10,-16,20,10,0.5,2.0,76.46397527910685,1.2894736842105263
223,2013/2014,England Premier League,Crystal Palace,33,48,45.0,38,-15,11,-15,20,11,0.55,3.0,71.48081930031691,1.1842105263157894
224,2013/2014,England Premier League,Swansea City,54,54,42.0,38,0,12,0,20,12,0.6,3.0,75.68152144950707,1.105263157894737
225,2013/2014,England Premier League,West Ham United,40,51,40.0,38,-11,13,-11,20,13,0.65,3.0,73.2076699350623,1.0526315789473684
226,2013/2014,England Premier League,Sunderland,41,60,38.0,38,-19,14,-19,20,14,0.7,3.0,73.20586737823581,1.0
227,2013/2014,England Premier League,Aston Villa,39,61,38.0,38,-22,15,-22,20,15,0.75,3.0,73.53985532011848,1.0
228,2013/2014,England Premier League,Hull City,38,53,37.0,38,-15,16,-15,20,16,0.8,4.0,71.96565656565659,0.9736842105263158
229,2013/2014,England Premier League,West Bromwich Albion,43,59,36.0,38,-16,17,-16,20,17,0.85,4.0,73.74010214931269,0.9473684210526315
230,2013/2014,England Premier League,Norwich City,28,62,33.0,38,-34,18,-34,20,18,0.9,4.0,74.11199589883799,0.868421052631579
231,2013/2014,England Premier League,Fulham,40,85,32.0,38,-45,19,-45,20,19,0.95,4.0,75.08305319082834,0.8421052631578947
232,2013/2014,England Premier League,Cardiff City,32,74,30.0,38,-42,20,-42,20,20,1.0,4.0,71.94511657932712,0.7894736842105263
233,2014/2015,England Premier League,Chelsea,73,32,87.0,38,41,1,41,20,1,0.05,1.0,82.77294657097289,2.289473684210526
234,2014/2015,England Premier League,Manchester City,83,38,79.0,38,45,2,45,20,2,0.1,1.0,82.13779567720957,2.0789473684210527
235,2014/2015,England Premier League,Arsenal,71,36,75.0,38,35,3,35,20,3,0.15,1.0,79.00577580314425,1.9736842105263157
236,2014/2015,England Premier League,Manchester United,62,37,70.0,38,25,4,25,20,4,0.2,1.0,80.27417360147942,1.8421052631578947
237,2014/2015,England Premier League,Tottenham Hotspur,58,53,64.0,38,5,5,5,20,5,0.25,1.0,77.21460995145205,1.6842105263157894
238,2014/2015,England Premier League,Liverpool,52,48,62.0,38,4,6,4,20,6,0.3,2.0,78.61209972244662,1.631578947368421
239,2014/2015,England Premier League,Southampton,54,33,60.0,38,21,7,21,20,7,0.35,2.0,75.63063599080346,1.5789473684210527
240,2014/2015,England Premier League,Swansea City,46,49,56.0,38,-3,8,-3,20,8,0.4,2.0,74.96412891986064,1.4736842105263157
241,2014/2015,England Premier League,Stoke City,48,45,54.0,38,3,9,3,20,9,0.45,2.0,75.14122807017544,1.4210526315789473
242,2014/2015,England Premier League,Crystal Palace,47,51,48.0,38,-4,10,-4,20,10,0.5,2.0,73.2279650174387,1.263157894736842
243,2014/2015,England Premier League,Everton,48,50,47.0,38,-2,11,-2,20,11,0.55,3.0,78.13724859669836,1.236842105263158
244,2014/2015,England Premier League,West Ham United,44,47,47.0,38,-3,12,-3,20,12,0.6,3.0,73.73251028806582,1.236842105263158
245,2014/2015,England Premier League,West Bromwich Albion,38,51,44.0,38,-13,13,-13,20,13,0.65,3.0,73.66578159041396,1.1578947368421053
246,2014/2015,England Premier League,Leicester City,46,55,41.0,38,-9,14,-9,20,14,0.7,3.0,70.60466507177034,1.0789473684210527
247,2014/2015,England Premier League,Newcastle United,40,63,39.0,38,-23,15,-23,20,15,0.75,3.0,73.7523524720893,1.0263157894736843
248,2014/2015,England Premier League,Sunderland,31,53,38.0,38,-22,16,-22,20,16,0.8,4.0,73.55677830940988,1.0
249,2014/2015,England Premier League,Aston Villa,31,57,38.0,38,-26,17,-26,20,17,0.85,4.0,74.39097335413126,1.0
250,2014/2015,England Premier League,Hull City,33,51,35.0,38,-18,18,-18,20,18,0.9,4.0,72.33285486443381,0.9210526315789473
251,2014/2015,England Premier League,Burnley,28,53,33.0,38,-25,19,-25,20,19,0.95,4.0,70.47931890677107,0.868421052631579
252,2014/2015,England Premier League,Queens Park Rangers,42,73,30.0,38,-31,20,-31,20,20,1.0,4.0,73.72521265284422,0.7894736842105263
253,2015/2016,England Premier League,Leicester City,68,36,81.0,38,32,1,32,20,1,0.05,1.0,74.894762215456,2.1315789473684212
254,2015/2016,England Premier League,Arsenal,65,36,71.0,38,29,2,29,20,2,0.1,1.0,80.97520790612894,1.868421052631579
255,2015/2016,England Premier League,Tottenham Hotspur,69,35,70.0,38,34,3,34,20,3,0.15,1.0,78.95178286625654,1.8421052631578947
256,2015/2016,England Premier League,Manchester City,71,41,66.0,38,30,4,30,20,4,0.2,1.0,82.03058213716108,1.736842105263158
257,2015/2016,England Premier League,Manchester United,49,35,66.0,38,14,5,14,20,5,0.25,1.0,79.95837320574161,1.736842105263158
258,2015/2016,England Premier League,Southampton,59,41,63.0,38,18,6,18,20,6,0.3,2.0,76.40362838915472,1.6578947368421053
259,2015/2016,England Premier League,West Ham United,65,51,62.0,38,14,7,14,20,7,0.35,2.0,76.23095524267396,1.631578947368421
260,2015/2016,England Premier League,Liverpool,63,50,60.0,38,13,8,13,20,8,0.4,2.0,78.05197368421055,1.5789473684210527
261,2015/2016,England Premier League,Stoke City,41,55,51.0,38,-14,9,-14,20,9,0.45,2.0,76.56939870337,1.3421052631578947
262,2015/2016,England Premier League,Chelsea,59,53,50.0,38,6,10,6,20,10,0.5,2.0,82.44449001291107,1.3157894736842106
263,2015/2016,England Premier League,Everton,59,55,47.0,38,4,11,4,20,11,0.55,3.0,77.75157017243347,1.236842105263158
264,2015/2016,England Premier League,Swansea City,42,52,47.0,38,-10,12,-10,20,12,0.6,3.0,76.73612535125694,1.236842105263158
265,2015/2016,England Premier League,Watford,40,50,45.0,38,-10,13,-10,20,13,0.65,3.0,74.13350421508316,1.1842105263157894
266,2015/2016,England Premier League,West Bromwich Albion,34,48,43.0,38,-14,14,-14,20,14,0.7,3.0,74.68700159489633,1.131578947368421
267,2015/2016,England Premier League,Crystal Palace,39,51,42.0,38,-12,15,-12,20,15,0.75,3.0,75.57059314954051,1.105263157894737
268,2015/2016,England Premier League,Bournemouth,45,67,42.0,38,-22,16,-22,20,16,0.8,4.0,72.19377990430623,1.105263157894737
269,2015/2016,England Premier League,Sunderland,48,62,39.0,38,-14,17,-14,20,17,0.85,4.0,75.10631313131312,1.0263157894736843
270,2015/2016,England Premier League,Newcastle United,44,65,37.0,38,-21,18,-21,20,18,0.9,4.0,75.27031214399634,0.9736842105263158
271,2015/2016,England Premier League,Norwich City,39,67,34.0,38,-28,19,-28,20,19,0.95,4.0,73.4096263385737,0.8947368421052632
272,2015/2016,England Premier League,Aston Villa,27,76,17.0,38,-49,20,-49,20,20,1.0,4.0,74.83714779372674,0.4473684210526316
433,2008/2009,Germany 1. Bundesliga,VfL Wolfsburg,80,41,69.0,34,39,1,39,18,1,0.05555555555555555,1.0,75.89757412398924,2.0294117647058822
434,2008/2009,Germany 1. Bundesliga,FC Bayern Munich,71,42,67.0,34,29,2,29,18,2,0.1111111111111111,1.0,82.20588235294119,1.9705882352941178
435,2008/2009,Germany 1. Bundesliga,VfB Stuttgart,63,43,64.0,34,20,3,20,18,3,0.16666666666666666,1.0,75.54679144385027,1.8823529411764706
436,2008/2009,Germany 1. Bundesliga,Hertha BSC Berlin,48,41,63.0,34,7,4,7,18,4,0.2222222222222222,1.0,74.03753351206433,1.8529411764705883
437,2008/2009,Germany 1. Bundesliga,Hamburger SV,49,47,61.0,34,2,5,2,18,5,0.2777777777777778,2.0,76.35561497326204,1.7941176470588236
438,2008/2009,Germany 1. Bundesliga,Borussia Dortmund,60,37,59.0,34,23,6,23,18,6,0.3333333333333333,2.0,75.69117647058823,1.7352941176470589
439,2008/2009,Germany 1. Bundesliga,TSG 1899 Hoffenheim,63,49,55.0,34,14,7,14,18,7,0.3888888888888889,2.0,71.9731182795699,1.6176470588235294
440,2008/2009,Germany 1. Bundesliga,FC Schalke 04,47,35,50.0,34,12,8,12,18,8,0.4444444444444444,2.0,78.63903743315507,1.4705882352941178
441,2008/2009,Germany 1. Bundesliga,Bayer 04 Leverkusen,59,46,49.0,34,13,9,13,18,9,0.5,2.0,77.84864864864866,1.4411764705882353
442,2008/2009,Germany 1. Bundesliga,SV Werder Bremen,64,50,45.0,34,14,10,14,18,10,0.5555555555555556,3.0,77.96524064171123,1.3235294117647058
443,2008/2009,Germany 1. Bundesliga,Hannover 96,49,69,40.0,34,-20,11,-20,18,11,0.6111111111111112,3.0,73.37154696132598,1.1764705882352942
444,2008/2009,Germany 1. Bundesliga,1. FC Köln,35,50,39.0,34,-15,12,-15,18,12,0.6666666666666666,3.0,70.83689839572192,1.1470588235294117
445,2008/2009,Germany 1. Bundesliga,Eintracht Frankfurt,39,60,33.0,34,-21,13,-21,18,13,0.7222222222222222,3.0,71.77809798270893,0.9705882352941176
446,2008/2009,Germany 1. Bundesliga,VfL Bochum,39,55,32.0,34,-16,14,-16,18,14,0.7777777777777778,4.0,71.76430517711172,0.9411764705882353
447,2008/2009,Germany 1. Bundesliga,Borussia Mönchengladbach,39,62,31.0,34,-23,15,-23,18,15,0.8333333333333334,4.0,70.91807909604519,0.9117647058823529
448,2008/2009,Germany 1. Bundesliga,FC Energie Cottbus,30,57,30.0,34,-27,16,-27,18,16,0.8888888888888888,4.0,68.73497267759562,0.8823529411764706
449,2008/2009,Germany 1. Bundesliga,Karlsruher SC,30,54,29.0,34,-24,17,-24,18,17,0.9444444444444444,4.0,70.85054347826086,0.8529411764705882
450,2008/2009,Germany 1. Bundesliga,DSC Arminia Bielefeld,29,56,28.0,34,-27,18,-27,18,18,1.0,4.0,70.13636363636363,0.8235294117647058
451,2009/2010,Germany 1. Bundesliga,FC Bayern Munich,72,31,70.0,34,41,1,41,18,1,0.05555555555555555,1.0,79.41711229946524,2.0588235294117645
452,2009/2010,Germany 1. Bundesliga,FC Schalke 04,53,31,65.0,34,22,2,22,18,2,0.1111111111111111,1.0,76.40909090909089,1.911764705882353
453,2009/2010,Germany 1. Bundesliga,SV Werder Bremen,71,40,61.0,34,31,3,31,18,3,0.16666666666666666,1.0,78.40909090909092,1.7941176470588236
454,2009/2010,Germany 1. Bundesliga,Bayer 04 Leverkusen,65,38,59.0,34,27,4,27,18,4,0.2222222222222222,1.0,77.41844919786098,1.7352941176470589
455,2009/2010,Germany 1. Bundesliga,Borussia Dortmund,54,42,57.0,34,12,5,12,18,5,0.2777777777777778,2.0,76.22860962566844,1.6764705882352942
456,2009/2010,Germany 1. Bundesliga,VfB Stuttgart,51,41,55.0,34,10,6,10,18,6,0.3333333333333333,2.0,76.23663101604278,1.6176470588235294
457,2009/2010,Germany 1. Bundesliga,Hamburger SV,56,41,52.0,34,15,7,15,18,7,0.3888888888888889,2.0,77.44652406417111,1.5294117647058822
458,2009/2010,Germany 1. Bundesliga,VfL Wolfsburg,64,58,50.0,34,6,8,6,18,8,0.4444444444444444,2.0,78.0427807486631,1.4705882352941178
459,2009/2010,Germany 1. Bundesliga,1. FSV Mainz 05,36,42,47.0,34,-6,9,-6,18,9,0.5,2.0,71.11497326203208,1.3823529411764706
460,2009/2010,Germany 1. Bundesliga,Eintracht Frankfurt,47,54,46.0,34,-7,10,-7,18,10,0.5555555555555556,3.0,72.91786743515851,1.3529411764705883
461,2009/2010,Germany 1. Bundesliga,TSG 1899 Hoffenheim,44,42,42.0,34,2,11,2,18,11,0.6111111111111112,3.0,76.19251336898397,1.2352941176470589
462,2009/2010,Germany 1. Bundesliga,Borussia Mönchengladbach,43,60,39.0,34,-17,12,-17,18,12,0.6666666666666666,3.0,73.19786096256684,1.1470588235294117
463,2009/2010,Germany 1. Bundesliga,1. FC Köln,33,42,38.0,34,-9,13,-9,18,13,0.7222222222222222,3.0,73.77479892761394,1.1176470588235294
464,2009/2010,Germany 1. Bundesliga,SC Freiburg,35,59,35.0,34,-24,14,-24,18,14,0.7777777777777778,4.0,69.21925133689841,1.0294117647058822
465,2009/2010,Germany 1. Bundesliga,Hannover 96,43,67,33.0,34,-24,15,-24,18,15,0.8333333333333334,4.0,72.0965147453083,0.9705882352941176
466,2009/2010,Germany 1. Bundesliga,1. FC Nürnberg,32,58,31.0,34,-26,16,-26,18,16,0.8888888888888888,4.0,70.60828877005348,0.9117647058823529
467,2009/2010,Germany 1. Bundesliga,VfL Bochum,33,64,28.0,34,-31,17,-31,18,17,0.9444444444444444,4.0,71.67134831460673,0.8235294117647058
468,2009/2010,Germany 1. Bundesliga,Hertha BSC Berlin,34,56,24.0,34,-22,18,-22,18,18,1.0,4.0,73.88648648648649,0.7058823529411765
469,2010/2011,Germany 1. Bundesliga,Borussia Dortmund,67,22,75.0,34,45,1,45,18,1,0.05555555555555555,1.0,77.0,2.2058823529411766
470,2010/2011,Germany 1. Bundesliga,Bayer 04 Leverkusen,64,44,68.0,34,20,2,20,18,2,0.1111111111111111,1.0,78.03877005347594,2.0
471,2010/2011,Germany 1. Bundesliga,FC Bayern Munich,81,40,65.0,34,41,3,41,18,3,0.16666666666666666,1.0,80.29144385026738,1.911764705882353
472,2010/2011,Germany 1. Bundesliga,Hannover 96,49,45,60.0,34,4,4,4,18,4,0.2222222222222222,1.0,72.37032085561498,1.7647058823529411
473,2010/2011,Germany 1. Bundesliga,1. FSV Mainz 05,52,39,58.0,34,13,5,13,18,5,0.2777777777777778,2.0,71.89438502673798,1.7058823529411764
474,2010/2011,Germany 1. Bundesliga,1. FC Nürnberg,47,45,47.0,34,2,6,2,18,6,0.3333333333333333,2.0,70.65013404825736,1.3823529411764706
475,2010/2011,Germany 1. Bundesliga,1. FC Kaiserslautern,48,51,46.0,34,-3,7,-3,18,7,0.3888888888888889,2.0,69.82123655913979,1.3529411764705883
476,2010/2011,Germany 1. Bundesliga,Hamburger SV,46,52,45.0,34,-6,8,-6,18,8,0.4444444444444444,2.0,76.85294117647061,1.3235294117647058
477,2010/2011,Germany 1. Bundesliga,SC Freiburg,41,50,44.0,34,-9,9,-9,18,9,0.5,2.0,70.7072192513369,1.2941176470588236
478,2010/2011,Germany 1. Bundesliga,1. FC Köln,47,62,44.0,34,-15,10,-15,18,10,0.5555555555555556,3.0,73.17647058823529,1.2941176470588236
479,2010/2011,Germany 1. Bundesliga,TSG 1899 Hoffenheim,50,50,43.0,34,0,11,0,18,11,0.6111111111111112,3.0,74.3542780748663,1.2647058823529411
480,2010/2011,Germany 1. Bundesliga,VfB Stuttgart,60,59,42.0,34,1,12,1,18,12,0.6666666666666666,3.0,74.57887700534761,1.2352941176470589
481,2010/2011,Germany 1. Bundesliga,SV Werder Bremen,47,61,41.0,34,-14,13,-14,18,13,0.7222222222222222,3.0,76.37265415549597,1.2058823529411764
482,2010/2011,Germany 1. Bundesliga,FC Schalke 04,38,44,40.0,34,-6,14,-6,18,14,0.7777777777777778,4.0,76.76881720430106,1.1764705882352942
483,2010/2011,Germany 1. Bundesliga,VfL Wolfsburg,43,48,38.0,34,-5,15,-5,18,15,0.8333333333333334,4.0,77.3850267379679,1.1176470588235294
484,2010/2011,Germany 1. Bundesliga,Borussia Mönchengladbach,48,65,36.0,34,-17,16,-17,18,16,0.8888888888888888,4.0,72.42780748663104,1.0588235294117647
485,2010/2011,Germany 1. Bundesliga,Eintracht Frankfurt,31,49,34.0,34,-18,17,-18,18,17,0.9444444444444444,4.0,72.79892761394102,1.0
486,2010/2011,Germany 1. Bundesliga,FC St. Pauli,35,68,29.0,34,-33,18,-33,18,18,1.0,4.0,69.28609625668449,0.8529411764705882
487,2011/2012,Germany 1. Bundesliga,Borussia Dortmund,80,25,81.0,34,55,1,55,18,1,0.05555555555555555,1.0,78.97326203208557,2.3823529411764706
488,2011/2012,Germany 1. Bundesliga,FC Bayern Munich,77,22,73.0,34,55,2,55,18,2,0.1111111111111111,1.0,82.47326203208556,2.1470588235294117
489,2011/2012,Germany 1. Bundesliga,FC Schalke 04,74,44,64.0,34,30,3,30,18,3,0.16666666666666666,1.0,76.06417112299465,1.8823529411764706
490,2011/2012,Germany 1. Bundesliga,Borussia Mönchengladbach,49,24,60.0,34,25,4,25,18,4,0.2222222222222222,1.0,73.84358288770055,1.7647058823529411
491,2011/2012,Germany 1. Bundesliga,Bayer 04 Leverkusen,52,44,54.0,34,8,5,8,18,5,0.2777777777777778,2.0,76.95855614973262,1.588235294117647
492,2011/2012,Germany 1. Bundesliga,VfB Stuttgart,63,46,53.0,34,17,6,17,18,6,0.3333333333333333,2.0,75.01871657754012,1.5588235294117647
493,2011/2012,Germany 1. Bundesliga,Hannover 96,41,45,48.0,34,-4,7,-4,18,7,0.3888888888888889,2.0,75.201871657754,1.411764705882353
494,2011/2012,Germany 1. Bundesliga,VfL Wolfsburg,47,60,44.0,34,-13,8,-13,18,8,0.4444444444444444,2.0,74.69919786096256,1.2941176470588236
495,2011/2012,Germany 1. Bundesliga,SV Werder Bremen,49,58,42.0,34,-9,9,-9,18,9,0.5,2.0,74.56951871657755,1.2352941176470589
496,2011/2012,Germany 1. Bundesliga,1. FC Nürnberg,38,49,42.0,34,-11,10,-11,18,10,0.5555555555555556,3.0,72.12165775401068,1.2352941176470589
497,2011/2012,Germany 1. Bundesliga,TSG 1899 Hoffenheim,41,47,41.0,34,-6,11,-6,18,11,0.6111111111111112,3.0,73.73930481283423,1.2058823529411764
498,2011/2012,Germany 1. Bundesliga,SC Freiburg,45,61,40.0,34,-16,12,-16,18,12,0.6666666666666666,3.0,70.24064171122994,1.1764705882352942
499,2011/2012,Germany 1. Bundesliga,1. FSV Mainz 05,47,51,39.0,34,-4,13,-4,18,13,0.7222222222222222,3.0,72.24064171122994,1.1470588235294117
500,2011/2012,Germany 1. Bundesliga,FC Augsburg,36,49,38.0,34,-13,14,-13,18,14,0.7777777777777778,4.0,69.19117647058823,1.1176470588235294
501,2011/2012,Germany 1. Bundesliga,Hamburger SV,35,57,36.0,34,-22,15,-22,18,15,0.8333333333333334,4.0,74.98930481283422,1.0588235294117647
502,2011/2012,Germany 1. Bundesliga,Hertha BSC Berlin,38,64,31.0,34,-26,16,-26,18,16,0.8888888888888888,4.0,72.5295698924731,0.9117647058823529
503,2011/2012,Germany 1. Bundesliga,1. FC Köln,39,75,30.0,34,-36,17,-36,18,17,0.9444444444444444,4.0,74.24331550802138,0.8823529411764706
504,2011/2012,Germany 1. Bundesliga,1. FC Kaiserslautern,24,54,23.0,34,-30,18,-30,18,18,1.0,4.0,70.44220430107528,0.6764705882352942
505,2012/2013,Germany 1. Bundesliga,FC Bayern Munich,98,18,91.0,34,80,1,80,18,1,0.05555555555555555,1.0,83.10957473898651,2.676470588235294
506,2012/2013,Germany 1. Bundesliga,Borussia Dortmund,81,42,66.0,34,39,2,39,18,2,0.1111111111111111,1.0,80.86492657669129,1.9411764705882353
507,2012/2013,Germany 1. Bundesliga,Bayer 04 Leverkusen,65,39,65.0,34,26,3,26,18,3,0.16666666666666666,1.0,77.61850649350649,1.911764705882353
508,2012/2013,Germany 1. Bundesliga,FC Schalke 04,58,50,55.0,34,8,4,8,18,4,0.2222222222222222,1.0,77.35909090909092,1.6176470588235294
509,2012/2013,Germany 1. Bundesliga,SC Freiburg,45,40,51.0,34,5,5,5,18,5,0.2777777777777778,2.0,73.19751082251082,1.5
510,2012/2013,Germany 1. Bundesliga,Eintracht Frankfurt,49,46,51.0,34,3,6,3,18,6,0.3333333333333333,2.0,74.00989304812833,1.5
511,2012/2013,Germany 1. Bundesliga,Hamburger SV,42,53,48.0,34,-11,7,-11,18,7,0.3888888888888889,2.0,75.70699431287667,1.411764705882353
512,2012/2013,Germany 1. Bundesliga,Borussia Mönchengladbach,45,49,47.0,34,-4,8,-4,18,8,0.4444444444444444,2.0,74.9196842373313,1.3823529411764706
513,2012/2013,Germany 1. Bundesliga,Hannover 96,60,62,45.0,34,-2,9,-2,18,9,0.5,2.0,74.9153743315508,1.3235294117647058
514,2012/2013,Germany 1. Bundesliga,1. FC Nürnberg,39,47,44.0,34,-8,10,-8,18,10,0.5555555555555556,3.0,73.35318309141836,1.2941176470588236
515,2012/2013,Germany 1. Bundesliga,VfL Wolfsburg,47,52,43.0,34,-5,11,-5,18,11,0.6111111111111112,3.0,76.33833078686021,1.2647058823529411
516,2012/2013,Germany 1. Bundesliga,VfB Stuttgart,37,55,43.0,34,-18,12,-18,18,12,0.6666666666666666,3.0,75.42063443834836,1.2647058823529411
517,2012/2013,Germany 1. Bundesliga,1. FSV Mainz 05,42,44,42.0,34,-2,13,-2,18,13,0.7222222222222222,3.0,73.05698370257194,1.2352941176470589
518,2012/2013,Germany 1. Bundesliga,SV Werder Bremen,50,66,34.0,34,-16,14,-16,18,14,0.7777777777777778,4.0,74.84074357015535,1.0
519,2012/2013,Germany 1. Bundesliga,FC Augsburg,33,51,33.0,34,-18,15,-18,18,15,0.8333333333333334,4.0,70.79291443850268,0.9705882352941176
520,2012/2013,Germany 1. Bundesliga,TSG 1899 Hoffenheim,42,67,31.0,34,-25,16,-25,18,16,0.8888888888888888,4.0,73.35196078431372,0.9117647058823529
521,2012/2013,Germany 1. Bundesliga,Fortuna Düsseldorf,39,57,30.0,34,-18,17,-18,18,17,0.9444444444444444,4.0,70.1704461536681,0.8823529411764706
522,2012/2013,Germany 1. Bundesliga,SpVgg Greuther Fürth,26,60,21.0,34,-34,18,-34,18,18,1.0,4.0,69.31778074866311,0.6176470588235294
523,2013/2014,Germany 1. Bundesliga,FC Bayern Munich,94,23,90.0,34,71,1,71,18,1,0.05555555555555555,1.0,83.3886586452763,2.6470588235294117
524,2013/2014,Germany 1. Bundesliga,Borussia Dortmund,80,38,71.0,34,42,2,42,18,2,0.1111111111111111,1.0,80.31325207769058,2.088235294117647
525,2013/2014,Germany 1. Bundesliga,FC Schalke 04,63,43,64.0,34,20,3,20,18,3,0.16666666666666666,1.0,75.82506382506384,1.8823529411764706
526,2013/2014,Germany 1. Bundesliga,Bayer 04 Leverkusen,60,41,61.0,34,19,4,19,18,4,0.2222222222222222,1.0,77.17291189202955,1.7941176470588236
527,2013/2014,Germany 1. Bundesliga,VfL Wolfsburg,63,50,60.0,34,13,5,13,18,5,0.2777777777777778,2.0,76.64124437653851,1.7647058823529411
528,2013/2014,Germany 1. Bundesliga,Borussia Mönchengladbach,59,43,55.0,34,16,6,16,18,6,0.3333333333333333,2.0,76.21616373822256,1.6176470588235294
529,2013/2014,Germany 1. Bundesliga,1. FSV Mainz 05,52,54,53.0,34,-2,7,-2,18,7,0.3888888888888889,2.0,72.57721926766045,1.5588235294117647
530,2013/2014,Germany 1. Bundesliga,FC Augsburg,47,47,52.0,34,0,8,0,18,8,0.4444444444444444,2.0,72.21351540616246,1.5294117647058822
531,2013/2014,Germany 1. Bundesliga,TSG 1899 Hoffenheim,72,70,44.0,34,2,9,2,18,9,0.5,2.0,73.32483505799013,1.2941176470588236
532,2013/2014,Germany 1. Bundesliga,Hannover 96,46,59,42.0,34,-13,10,-13,18,10,0.5555555555555556,3.0,74.01066856494664,1.2352941176470589
533,2013/2014,Germany 1. Bundesliga,Hertha BSC Berlin,40,48,41.0,34,-8,11,-8,18,11,0.6111111111111112,3.0,73.19124919198447,1.2058823529411764
534,2013/2014,Germany 1. Bundesliga,SV Werder Bremen,42,66,39.0,34,-24,12,-24,18,12,0.6666666666666666,3.0,73.47108383298222,1.1470588235294117
535,2013/2014,Germany 1. Bundesliga,Eintracht Frankfurt,40,57,36.0,34,-17,13,-17,18,13,0.7222222222222222,3.0,74.72772048213224,1.0588235294117647
536,2013/2014,Germany 1. Bundesliga,SC Freiburg,43,61,36.0,34,-18,14,-18,18,14,0.7777777777777778,4.0,72.03415917250064,1.0588235294117647
537,2013/2014,Germany 1. Bundesliga,VfB Stuttgart,49,62,32.0,34,-13,15,-13,18,15,0.8333333333333334,4.0,74.69470970206267,0.9411764705882353
538,2013/2014,Germany 1. Bundesliga,Hamburger SV,51,75,27.0,34,-24,16,-24,18,16,0.8888888888888888,4.0,74.27862804901574,0.7941176470588235
539,2013/2014,Germany 1. Bundesliga,1. FC Nürnberg,37,70,26.0,34,-33,17,-33,18,17,0.9444444444444444,4.0,72.5293104845244,0.7647058823529411
540,2013/2014,Germany 1. Bundesliga,Eintracht Braunschweig,29,60,25.0,34,-31,18,-31,18,18,1.0,4.0,69.55762032085563,0.7352941176470589
541,2014/2015,Germany 1. Bundesliga,FC Bayern Munich,80,18,79.0,34,62,1,62,18,1,0.05555555555555555,1.0,83.289141896428,2.323529411764706
542,2014/2015,Germany 1. Bundesliga,VfL Wolfsburg,72,38,69.0,34,34,2,34,18,2,0.1111111111111111,1.0,78.35196213471616,2.0294117647058822
543,2014/2015,Germany 1. Bundesliga,Borussia Mönchengladbach,53,26,66.0,34,27,3,27,18,3,0.16666666666666666,1.0,76.61761620732209,1.9411764705882353
544,2014/2015,Germany 1. Bundesliga,Bayer 04 Leverkusen,62,37,61.0,34,25,4,25,18,4,0.2222222222222222,1.0,76.89369201060377,1.7941176470588236
545,2014/2015,Germany 1. Bundesliga,FC Augsburg,43,43,49.0,34,0,5,0,18,5,0.2777777777777778,2.0,73.20201750121535,1.4411764705882353
546,2014/2015,Germany 1. Bundesliga,FC Schalke 04,42,40,48.0,34,2,6,2,18,6,0.3333333333333333,2.0,76.2156489455286,1.411764705882353
547,2014/2015,Germany 1. Bundesliga,Borussia Dortmund,47,42,46.0,34,5,7,5,18,7,0.3888888888888889,2.0,80.23583524318816,1.3529411764705883
548,2014/2015,Germany 1. Bundesliga,TSG 1899 Hoffenheim,49,55,44.0,34,-6,8,-6,18,8,0.4444444444444444,2.0,75.27429971988794,1.2941176470588236
549,2014/2015,Germany 1. Bundesliga,Eintracht Frankfurt,56,62,43.0,34,-6,9,-6,18,9,0.5,2.0,74.06249999999999,1.2647058823529411
550,2014/2015,Germany 1. Bundesliga,SV Werder Bremen,50,65,43.0,34,-15,10,-15,18,10,0.5555555555555556,3.0,72.07576095045424,1.2647058823529411
551,2014/2015,Germany 1. Bundesliga,1. FSV Mainz 05,45,47,40.0,34,-2,11,-2,18,11,0.6111111111111112,3.0,73.42840815601512,1.1764705882352942
552,2014/2015,Germany 1. Bundesliga,1. FC Köln,34,40,40.0,34,-6,12,-6,18,12,0.6666666666666666,3.0,71.96896485867073,1.1764705882352942
553,2014/2015,Germany 1. Bundesliga,Hannover 96,40,56,37.0,34,-16,13,-16,18,13,0.7222222222222222,3.0,73.6159090909091,1.088235294117647
554,2014/2015,Germany 1. Bundesliga,VfB Stuttgart,42,60,36.0,34,-18,14,-18,18,14,0.7777777777777778,4.0,73.11581996434938,1.0588235294117647
555,2014/2015,Germany 1. Bundesliga,Hertha BSC Berlin,36,52,35.0,34,-16,15,-16,18,15,0.8333333333333334,4.0,73.69978354978355,1.0294117647058822
556,2014/2015,Germany 1. Bundesliga,Hamburger SV,25,50,35.0,34,-25,16,-25,18,16,0.8888888888888888,4.0,74.41834415584415,1.0294117647058822
557,2014/2015,Germany 1. Bundesliga,SC Freiburg,36,47,34.0,34,-11,17,-11,18,17,0.9444444444444444,4.0,71.95047011811717,1.0
558,2014/2015,Germany 1. Bundesliga,SC Paderborn 07,31,65,31.0,34,-34,18,-34,18,18,1.0,4.0,68.49392029539088,0.9117647058823529
559,2015/2016,Germany 1. Bundesliga,FC Bayern Munich,80,17,88.0,34,63,1,63,18,1,0.05555555555555555,1.0,83.86448094389269,2.588235294117647
560,2015/2016,Germany 1. Bundesliga,Borussia Dortmund,82,34,78.0,34,48,2,48,18,2,0.1111111111111111,1.0,80.39032372855904,2.2941176470588234
561,2015/2016,Germany 1. Bundesliga,Bayer 04 Leverkusen,56,40,60.0,34,16,3,16,18,3,0.16666666666666666,1.0,77.71693404634581,1.7647058823529411
562,2015/2016,Germany 1. Bundesliga,Borussia Mönchengladbach,67,50,55.0,34,17,4,17,18,4,0.2222222222222222,1.0,76.12953301155171,1.6176470588235294
563,2015/2016,Germany 1. Bundesliga,FC Schalke 04,51,49,52.0,34,2,5,2,18,5,0.2777777777777778,2.0,77.50273529116718,1.5294117647058822
564,2015/2016,Germany 1. Bundesliga,1. FSV Mainz 05,46,42,50.0,34,4,6,4,18,6,0.3333333333333333,2.0,74.35328707240473,1.4705882352941178
565,2015/2016,Germany 1. Bundesliga,Hertha BSC Berlin,42,42,50.0,34,0,7,0,18,7,0.3888888888888889,2.0,74.70042044728577,1.4705882352941178
566,2015/2016,Germany 1. Bundesliga,VfL Wolfsburg,47,49,45.0,34,-2,8,-2,18,8,0.4444444444444444,2.0,79.33887191240134,1.3235294117647058
567,2015/2016,Germany 1. Bundesliga,1. FC Köln,38,42,43.0,34,-4,9,-4,18,9,0.5,2.0,75.01453804662358,1.2647058823529411
568,2015/2016,Germany 1. Bundesliga,Hamburger SV,40,46,41.0,34,-6,10,-6,18,10,0.5555555555555556,3.0,74.52202699261522,1.2058823529411764
569,2015/2016,Germany 1. Bundesliga,FC Ingolstadt 04,33,42,40.0,34,-9,11,-9,18,11,0.6111111111111112,3.0,71.27746371275781,1.1764705882352942
570,2015/2016,Germany 1. Bundesliga,FC Augsburg,42,52,38.0,34,-10,12,-10,18,12,0.6666666666666666,3.0,74.32633689839574,1.1176470588235294
571,2015/2016,Germany 1. Bundesliga,SV Werder Bremen,50,65,38.0,34,-15,13,-15,18,13,0.7222222222222222,3.0,73.69897731131017,1.1176470588235294
572,2015/2016,Germany 1. Bundesliga,SV Darmstadt 98,38,53,38.0,34,-15,14,-15,18,14,0.7777777777777778,4.0,71.47228849581792,1.1176470588235294
573,2015/2016,Germany 1. Bundesliga,TSG 1899 Hoffenheim,39,54,37.0,34,-15,15,-15,18,15,0.8333333333333334,4.0,75.1869620575503,1.088235294117647
574,2015/2016,Germany 1. Bundesliga,Eintracht Frankfurt,34,52,36.0,34,-18,16,-18,18,16,0.8888888888888888,4.0,74.50980392156862,1.0588235294117647
575,2015/2016,Germany 1. Bundesliga,VfB Stuttgart,50,75,33.0,34,-25,17,-25,18,17,0.9444444444444444,4.0,74.96444486885663,0.9705882352941176
576,2015/2016,Germany 1. Bundesliga,Hannover 96,31,62,25.0,34,-31,18,-31,18,18,1.0,4.0,73.43572701807997,0.7352941176470589
577,2008/2009,Italy Serie A,Inter,70,32,84.0,38,38,1,38,20,1,0.05,1.0,82.90510948905109,2.210526315789474
578,2008/2009,Italy Serie A,Milan,70,35,74.0,38,35,2,35,20,2,0.1,1.0,81.2879518072289,1.9473684210526316
579,2008/2009,Italy Serie A,Juventus,69,37,74.0,38,32,3,32,20,3,0.15,1.0,81.05980861244018,1.9473684210526316
580,2008/2009,Italy Serie A,Genoa,56,39,68.0,38,17,4,17,20,4,0.2,1.0,75.35888077858881,1.7894736842105263
581,2008/2009,Italy Serie A,Fiorentina,53,38,68.0,38,15,5,15,20,5,0.25,1.0,79.8433014354067,1.7894736842105263
582,2008/2009,Italy Serie A,Roma,64,61,63.0,38,3,6,3,20,6,0.3,2.0,80.58088235294117,1.6578947368421053
583,2008/2009,Italy Serie A,Udinese,61,50,58.0,38,11,7,11,20,7,0.35,2.0,76.35885167464114,1.5263157894736843
584,2008/2009,Italy Serie A,Palermo,57,50,57.0,38,7,8,7,20,8,0.4,2.0,74.80370370370369,1.5
585,2008/2009,Italy Serie A,Cagliari,49,50,53.0,38,-1,9,-1,20,9,0.45,2.0,73.64832535885168,1.394736842105263
586,2008/2009,Italy Serie A,Lazio,46,55,50.0,38,-9,10,-9,20,10,0.5,2.0,75.5317848410758,1.3157894736842106
587,2008/2009,Italy Serie A,Atalanta,45,48,47.0,38,-3,11,-3,20,11,0.55,3.0,73.30215827338131,1.236842105263158
588,2008/2009,Italy Serie A,Napoli,43,45,46.0,38,-2,12,-2,20,12,0.6,3.0,74.97368421052633,1.2105263157894737
589,2008/2009,Italy Serie A,Sampdoria,49,52,46.0,38,-3,13,-3,20,13,0.65,3.0,76.52392344497606,1.2105263157894737
590,2008/2009,Italy Serie A,Siena,33,44,44.0,38,-11,14,-11,20,14,0.7,3.0,72.1842105263158,1.1578947368421053
591,2008/2009,Italy Serie A,Catania,41,51,43.0,38,-10,15,-10,20,15,0.75,3.0,72.77349397590362,1.131578947368421
592,2008/2009,Italy Serie A,Chievo Verona,35,49,38.0,38,-14,16,-14,20,16,0.8,4.0,72.11678832116789,1.0
593,2008/2009,Italy Serie A,Bologna,43,62,37.0,38,-19,17,-19,20,17,0.85,4.0,69.70893719806763,0.9736842105263158
594,2008/2009,Italy Serie A,Torino,37,61,34.0,38,-24,18,-24,20,18,0.9,4.0,72.00366748166257,0.8947368421052632
595,2008/2009,Italy Serie A,Reggio Calabria,30,62,31.0,38,-32,19,-32,20,19,0.95,4.0,68.7267156862745,0.8157894736842105
596,2008/2009,Italy Serie A,Lecce,37,67,30.0,38,-30,20,-30,20,20,1.0,4.0,69.82014388489209,0.7894736842105263
597,2009/2010,Italy Serie A,Inter,75,34,82.0,38,41,1,41,20,1,0.05,1.0,83.82535885167464,2.1578947368421053
598,2009/2010,Italy Serie A,Roma,68,41,80.0,38,27,2,27,20,2,0.1,1.0,79.53237410071942,2.1052631578947367
599,2009/2010,Italy Serie A,Milan,60,39,70.0,38,21,3,21,20,3,0.15,1.0,80.33133971291866,1.8421052631578947
600,2009/2010,Italy Serie A,Sampdoria,49,41,67.0,38,8,4,8,20,4,0.2,1.0,76.22009569377992,1.763157894736842
601,2009/2010,Italy Serie A,Palermo,59,47,65.0,38,12,5,12,20,5,0.25,1.0,75.60401002506265,1.7105263157894737
602,2009/2010,Italy Serie A,Napoli,50,43,59.0,38,7,6,7,20,6,0.3,2.0,76.36004784688996,1.5526315789473684
603,2009/2010,Italy Serie A,Juventus,55,56,55.0,38,-1,7,-1,20,7,0.35,2.0,80.8468899521531,1.4473684210526316
604,2009/2010,Italy Serie A,Parma,46,51,52.0,38,-5,8,-5,20,8,0.4,2.0,72.84908136482939,1.368421052631579
605,2009/2010,Italy Serie A,Genoa,57,61,51.0,38,-4,9,-4,20,9,0.45,2.0,76.06265984654729,1.3421052631578947
606,2009/2010,Italy Serie A,Bari,49,49,50.0,38,0,10,0,20,10,0.5,2.0,70.43421052631578,1.3157894736842106
607,2009/2010,Italy Serie A,Fiorentina,48,47,47.0,38,1,11,1,20,11,0.55,3.0,78.57655502392343,1.236842105263158
608,2009/2010,Italy Serie A,Lazio,39,43,46.0,38,-4,12,-4,20,12,0.6,3.0,75.95173267326732,1.2105263157894737
609,2009/2010,Italy Serie A,Catania,44,45,45.0,38,-1,13,-1,20,13,0.65,3.0,74.11363636363637,1.1842105263157894
610,2009/2010,Italy Serie A,Cagliari,56,58,44.0,38,-2,14,-2,20,14,0.7,3.0,74.52392344497608,1.1578947368421053
611,2009/2010,Italy Serie A,Udinese,54,59,44.0,38,-5,15,-5,20,15,0.75,3.0,77.20813397129187,1.1578947368421053
612,2009/2010,Italy Serie A,Chievo Verona,37,42,44.0,38,-5,16,-5,20,16,0.8,4.0,72.19484240687679,1.1578947368421053
613,2009/2010,Italy Serie A,Bologna,42,55,42.0,38,-13,17,-13,20,17,0.85,4.0,70.625,1.105263157894737
614,2009/2010,Italy Serie A,Atalanta,37,53,35.0,38,-16,18,-16,20,18,0.9,4.0,73.6030534351145,0.9210526315789473
615,2009/2010,Italy Serie A,Siena,40,67,31.0,38,-27,19,-27,20,19,0.95,4.0,70.79468599033815,0.8157894736842105
616,2009/2010,Italy Serie A,Livorno,27,61,29.0,38,-34,20,-34,20,20,1.0,4.0,70.58052884615384,0.7631578947368421
617,2010/2011,Italy Serie A,Milan,65,24,82.0,38,41,1,41,20,1,0.05,1.0,79.90071770334929,2.1578947368421053
618,2010/2011,Italy Serie A,Inter,69,42,76.0,38,27,2,27,20,2,0.1,1.0,81.75478468899522,2.0
619,2010/2011,Italy Serie A,Napoli,59,39,70.0,38,20,3,20,20,3,0.15,1.0,77.59808612440193,1.8421052631578947
620,2010/2011,Italy Serie A,Udinese,65,43,66.0,38,22,4,22,20,4,0.2,1.0,75.5921052631579,1.736842105263158
621,2010/2011,Italy Serie A,Lazio,55,39,66.0,38,16,5,16,20,5,0.25,1.0,76.22182254196642,1.736842105263158
622,2010/2011,Italy Serie A,Roma,59,52,63.0,38,7,6,7,20,6,0.3,2.0,79.02392344497608,1.6578947368421053
623,2010/2011,Italy Serie A,Juventus,57,47,58.0,38,10,7,10,20,7,0.35,2.0,78.93899521531102,1.5263157894736843
624,2010/2011,Italy Serie A,Palermo,58,63,56.0,38,-5,8,-5,20,8,0.4,2.0,75.83014354066984,1.4736842105263157
625,2010/2011,Italy Serie A,Fiorentina,49,44,51.0,38,5,9,5,20,9,0.45,2.0,76.29186602870813,1.3421052631578947
626,2010/2011,Italy Serie A,Genoa,45,47,51.0,38,-2,10,-2,20,10,0.5,2.0,75.93301435406697,1.3421052631578947
627,2010/2011,Italy Serie A,Chievo Verona,38,40,46.0,38,-2,11,-2,20,11,0.55,3.0,72.72129186602871,1.2105263157894737
628,2010/2011,Italy Serie A,Parma,39,47,46.0,38,-8,12,-8,20,12,0.6,3.0,73.9766009852217,1.2105263157894737
629,2010/2011,Italy Serie A,Catania,40,52,46.0,38,-12,13,-12,20,13,0.65,3.0,72.62081339712917,1.2105263157894737
630,2010/2011,Italy Serie A,Cagliari,44,51,45.0,38,-7,14,-7,20,14,0.7,3.0,72.84928229665073,1.1842105263157894
631,2010/2011,Italy Serie A,Bologna,35,52,45.0,38,-17,15,-17,20,15,0.75,3.0,71.33851674641147,1.1842105263157894
632,2010/2011,Italy Serie A,Cesena,38,50,43.0,38,-12,16,-12,20,16,0.8,4.0,70.40191387559808,1.131578947368421
633,2010/2011,Italy Serie A,Lecce,46,66,41.0,38,-20,17,-20,20,17,0.85,4.0,69.07296650717704,1.0789473684210527
634,2010/2011,Italy Serie A,Sampdoria,33,49,36.0,38,-16,18,-16,20,18,0.9,4.0,75.82416267942584,0.9473684210526315
635,2010/2011,Italy Serie A,Brescia,34,52,32.0,38,-18,19,-18,20,19,0.95,4.0,69.28644501278771,0.8421052631578947
636,2010/2011,Italy Serie A,Bari,27,56,24.0,38,-29,20,-29,20,20,1.0,4.0,71.12620192307692,0.631578947368421
637,2011/2012,Italy Serie A,Juventus,64,19,79.0,35,45,1,45,20,1,0.05,1.0,81.01298701298701,2.257142857142857
638,2011/2012,Italy Serie A,Milan,72,33,77.0,37,39,2,39,20,2,0.1,1.0,80.74197530864197,2.081081081081081
639,2011/2012,Italy Serie A,Udinese,52,34,63.0,36,18,3,18,20,3,0.15,1.0,76.90909090909093,1.75
640,2011/2012,Italy Serie A,Napoli,64,41,60.0,36,23,4,23,20,4,0.2,1.0,79.55176767676768,1.6666666666666667
641,2011/2012,Italy Serie A,Lazio,53,43,59.0,36,10,5,10,20,5,0.25,1.0,77.42803030303031,1.6388888888888888
642,2011/2012,Italy Serie A,Inter,56,53,57.0,37,3,6,3,20,6,0.3,2.0,81.55773955773957,1.5405405405405406
643,2011/2012,Italy Serie A,Roma,59,52,56.0,37,7,7,7,20,7,0.35,2.0,77.26167076167074,1.5135135135135136
644,2011/2012,Italy Serie A,Parma,51,50,54.0,36,1,8,1,20,8,0.4,2.0,74.44303797468353,1.5
645,2011/2012,Italy Serie A,Atalanta,40,40,50.0,35,0,9,0,20,9,0.45,2.0,73.12467532467532,1.4285714285714286
646,2011/2012,Italy Serie A,Chievo Verona,33,44,46.0,37,-11,10,-11,20,10,0.5,2.0,73.16830466830466,1.2432432432432432
647,2011/2012,Italy Serie A,Bologna,36,41,44.0,35,-5,11,-5,20,11,0.55,3.0,73.06363636363636,1.2571428571428571
648,2011/2012,Italy Serie A,Palermo,52,62,43.0,38,-10,12,-10,20,12,0.6,3.0,74.84928229665071,1.131578947368421
649,2011/2012,Italy Serie A,Catania,42,48,42.0,34,-6,13,-6,20,13,0.65,3.0,73.24064171122994,1.2352941176470589
650,2011/2012,Italy Serie A,Fiorentina,32,38,42.0,34,-6,14,-6,20,14,0.7,3.0,75.98517520215633,1.2352941176470589
651,2011/2012,Italy Serie A,Cagliari,35,43,40.0,36,-8,15,-8,20,15,0.75,3.0,74.72979797979797,1.1111111111111112
652,2011/2012,Italy Serie A,Genoa,48,67,40.0,36,-19,16,-19,20,16,0.8,4.0,76.51790281329924,1.1111111111111112
653,2011/2012,Italy Serie A,Siena,40,45,38.0,36,-5,17,-5,20,17,0.85,4.0,69.74494949494948,1.0555555555555556
654,2011/2012,Italy Serie A,Lecce,38,52,34.0,35,-14,18,-14,20,18,0.9,4.0,70.4350649350649,0.9714285714285714
655,2011/2012,Italy Serie A,Novara,34,64,29.0,36,-30,19,-30,20,19,0.95,4.0,68.1610824742268,0.8055555555555556
656,2011/2012,Italy Serie A,Cesena,24,56,20.0,34,-32,20,-32,20,20,1.0,4.0,71.75421348314607,0.5882352941176471
657,2012/2013,Italy Serie A,Juventus,71,24,87.0,38,47,1,47,20,1,0.05,1.0,82.1168204602415,2.289473684210526
658,2012/2013,Italy Serie A,Napoli,73,36,78.0,38,37,2,37,20,2,0.1,1.0,80.22399179767602,2.0526315789473686
659,2012/2013,Italy Serie A,Milan,67,39,72.0,38,28,3,28,20,3,0.15,1.0,79.67989861016174,1.894736842105263
660,2012/2013,Italy Serie A,Fiorentina,72,44,70.0,38,28,4,28,20,4,0.2,1.0,77.85811973114605,1.8421052631578947
661,2012/2013,Italy Serie A,Udinese,59,45,66.0,38,14,5,14,20,5,0.25,1.0,75.90485019366601,1.736842105263158
662,2012/2013,Italy Serie A,Roma,71,56,62.0,38,15,6,15,20,6,0.3,2.0,76.8495670995671,1.631578947368421
663,2012/2013,Italy Serie A,Lazio,51,42,61.0,38,9,7,9,20,7,0.35,2.0,79.40467266651477,1.605263157894737
664,2012/2013,Italy Serie A,Catania,50,46,56.0,38,4,8,4,20,8,0.4,2.0,75.53740031897927,1.4736842105263157
665,2012/2013,Italy Serie A,Inter,55,57,54.0,38,-2,9,-2,20,9,0.45,2.0,79.62920369104579,1.4210526315789473
666,2012/2013,Italy Serie A,Parma,45,46,49.0,38,-1,10,-1,20,10,0.5,2.0,74.50825358851674,1.2894736842105263
667,2012/2013,Italy Serie A,Cagliari,43,55,47.0,38,-12,11,-12,20,11,0.55,3.0,74.77460127591705,1.236842105263158
668,2012/2013,Italy Serie A,Chievo Verona,37,52,45.0,38,-15,12,-15,20,12,0.6,3.0,74.1796536796537,1.1842105263157894
669,2012/2013,Italy Serie A,Bologna,46,52,44.0,38,-6,13,-6,20,13,0.65,3.0,73.5012077294686,1.1578947368421053
670,2012/2013,Italy Serie A,Sampdoria,43,51,43.0,38,-8,14,-8,20,14,0.7,3.0,72.55685805422648,1.131578947368421
671,2012/2013,Italy Serie A,Atalanta,39,56,42.0,38,-17,15,-17,20,15,0.75,3.0,75.04525518341306,1.105263157894737
672,2012/2013,Italy Serie A,Torino,46,55,40.0,38,-9,16,-9,20,16,0.8,4.0,74.52738285106706,1.0526315789473684
673,2012/2013,Italy Serie A,Genoa,38,52,38.0,38,-14,17,-14,20,17,0.85,4.0,74.5958733974359,1.0
674,2012/2013,Italy Serie A,Siena,36,57,36.0,38,-21,18,-21,20,18,0.9,4.0,70.73381180223286,0.9473684210526315
675,2012/2013,Italy Serie A,Palermo,34,54,32.0,38,-20,19,-20,20,19,0.95,4.0,73.28366940077467,0.8421052631578947
676,2012/2013,Italy Serie A,Pescara,27,84,22.0,38,-57,20,-57,20,20,1.0,4.0,69.55428723323459,0.5789473684210527
677,2013/2014,Italy Serie A,Juventus,80,23,102.0,38,57,1,57,20,1,0.05,1.0,81.65337101544735,2.6842105263157894
678,2013/2014,Italy Serie A,Roma,72,25,85.0,38,47,2,47,20,2,0.1,1.0,78.94222581365304,2.236842105263158
679,2013/2014,Italy Serie A,Napoli,77,39,78.0,38,38,3,38,20,3,0.15,1.0,78.38694152737216,2.0526315789473686
680,2013/2014,Italy Serie A,Fiorentina,65,44,65.0,38,21,4,21,20,4,0.2,1.0,77.90539796460848,1.7105263157894737
681,2013/2014,Italy Serie A,Inter,62,39,60.0,38,23,5,23,20,5,0.25,1.0,78.49745204954534,1.5789473684210527
682,2013/2014,Italy Serie A,Parma,58,46,58.0,38,12,6,12,20,6,0.3,2.0,74.62170431243396,1.5263157894736843
683,2013/2014,Italy Serie A,Torino,58,48,57.0,38,10,7,10,20,7,0.35,2.0,73.8704568562565,1.5
684,2013/2014,Italy Serie A,Milan,57,49,57.0,38,8,8,8,20,8,0.4,2.0,77.94388341589296,1.5
685,2013/2014,Italy Serie A,Lazio,54,54,56.0,38,0,9,0,20,9,0.45,2.0,77.32824960127591,1.4736842105263157
686,2013/2014,Italy Serie A,Hellas Verona,62,68,54.0,38,-6,10,-6,20,10,0.5,2.0,71.21397527910688,1.4210526315789473
687,2013/2014,Italy Serie A,Atalanta,43,51,50.0,38,-8,11,-8,20,11,0.55,3.0,73.8743889682885,1.3157894736842106
688,2013/2014,Italy Serie A,Sampdoria,48,62,45.0,38,-14,12,-14,20,12,0.6,3.0,71.26590778923253,1.1842105263157894
689,2013/2014,Italy Serie A,Genoa,41,50,44.0,38,-9,13,-9,20,13,0.65,3.0,73.03037612971823,1.1578947368421053
690,2013/2014,Italy Serie A,Udinese,46,57,44.0,38,-11,14,-11,20,14,0.7,3.0,75.04314373784892,1.1578947368421053
691,2013/2014,Italy Serie A,Cagliari,34,53,39.0,38,-19,15,-19,20,15,0.75,3.0,73.73736838653106,1.0263157894736843
692,2013/2014,Italy Serie A,Chievo Verona,34,54,36.0,38,-20,16,-20,20,16,0.8,4.0,72.66988338615134,0.9473684210526315
693,2013/2014,Italy Serie A,Sassuolo,43,72,34.0,38,-29,17,-29,20,17,0.85,4.0,70.09319415964153,0.8947368421052632
694,2013/2014,Italy Serie A,Catania,34,66,32.0,38,-32,18,-32,20,18,0.9,4.0,72.89156552511817,0.8421052631578947
695,2013/2014,Italy Serie A,Bologna,28,58,29.0,38,-30,19,-30,20,19,0.95,4.0,72.00178303886439,0.7631578947368421
696,2013/2014,Italy Serie A,Livorno,39,77,25.0,38,-38,20,-38,20,20,1.0,4.0,69.94307359307358,0.6578947368421053
697,2014/2015,Italy Serie A,Juventus,72,24,87.0,38,48,1,48,20,1,0.05,1.0,80.44986044657097,2.289473684210526
698,2014/2015,Italy Serie A,Roma,54,31,70.0,38,23,2,23,20,2,0.1,1.0,78.22513100934152,1.8421052631578947
699,2014/2015,Italy Serie A,Lazio,67,36,66.0,37,31,3,31,20,3,0.15,1.0,76.88005733005733,1.7837837837837838
700,2014/2015,Italy Serie A,Fiorentina,61,46,64.0,38,15,4,15,20,4,0.2,1.0,76.06960298473457,1.6842105263157894
701,2014/2015,Italy Serie A,Napoli,68,50,63.0,37,18,5,18,20,5,0.25,1.0,77.02335322335321,1.7027027027027026
702,2014/2015,Italy Serie A,Genoa,62,47,59.0,38,15,6,15,20,6,0.3,2.0,73.1835383914331,1.5526315789473684
703,2014/2015,Italy Serie A,Sampdoria,48,42,56.0,38,6,7,6,20,7,0.35,2.0,72.49362026862029,1.4736842105263157
704,2014/2015,Italy Serie A,Inter,59,48,55.0,38,11,8,11,20,8,0.4,2.0,77.22547376865562,1.4473684210526316
705,2014/2015,Italy Serie A,Torino,48,45,54.0,38,3,9,3,20,9,0.45,2.0,73.74687856003645,1.4210526315789473
706,2014/2015,Italy Serie A,Milan,56,50,52.0,38,6,10,6,20,10,0.5,2.0,77.37149407609935,1.368421052631579
707,2014/2015,Italy Serie A,Palermo,53,55,49.0,38,-2,11,-2,20,11,0.55,3.0,70.76717584648206,1.2894736842105263
708,2014/2015,Italy Serie A,Sassuolo,49,57,49.0,38,-8,12,-8,20,12,0.6,3.0,72.04555707450444,1.2894736842105263
709,2014/2015,Italy Serie A,Hellas Verona,49,65,46.0,38,-16,13,-16,20,13,0.65,3.0,71.1688824333561,1.2105263157894737
710,2014/2015,Italy Serie A,Chievo Verona,28,41,43.0,38,-13,14,-13,20,14,0.7,3.0,72.18676236044658,1.131578947368421
711,2014/2015,Italy Serie A,Empoli,46,52,42.0,38,-6,15,-6,20,15,0.75,3.0,70.20880260090787,1.105263157894737
712,2014/2015,Italy Serie A,Udinese,43,56,41.0,38,-13,16,-13,20,16,0.8,4.0,73.53321837651981,1.0789473684210527
713,2014/2015,Italy Serie A,Atalanta,38,57,37.0,38,-19,17,-19,20,17,0.85,4.0,71.90824029771397,0.9736842105263158
714,2014/2015,Italy Serie A,Cagliari,48,68,34.0,38,-20,18,-20,20,18,0.9,4.0,71.63279790385054,0.8947368421052632
715,2014/2015,Italy Serie A,Parma,33,75,26.0,38,-42,19,-42,20,19,0.95,4.0,71.38953116261727,0.6842105263157895
716,2014/2015,Italy Serie A,Cesena,36,73,24.0,38,-37,20,-37,20,20,1.0,4.0,67.8486315359477,0.631578947368421
717,2015/2016,Italy Serie A,Juventus,75,20,91.0,38,55,1,55,20,1,0.05,1.0,82.1076633759648,2.3947368421052633
718,2015/2016,Italy Serie A,Napoli,80,32,82.0,38,48,2,48,20,2,0.1,1.0,79.95121326042378,2.1578947368421053
719,2015/2016,Italy Serie A,Roma,83,41,80.0,38,42,3,42,20,3,0.15,1.0,79.45692779110045,2.1052631578947367
720,2015/2016,Italy Serie A,Inter,50,38,67.0,38,12,4,12,20,4,0.2,1.0,79.07015028332101,1.763157894736842
721,2015/2016,Italy Serie A,Fiorentina,60,42,64.0,38,18,5,18,20,5,0.25,1.0,76.85635635004829,1.6842105263157894
722,2015/2016,Italy Serie A,Sassuolo,49,40,61.0,38,9,6,9,20,6,0.3,2.0,73.96584695209098,1.605263157894737
723,2015/2016,Italy Serie A,Milan,49,43,57.0,38,6,7,6,20,7,0.35,2.0,77.17391515359141,1.5
724,2015/2016,Italy Serie A,Lazio,52,52,54.0,38,0,8,0,20,8,0.4,2.0,77.76389182322195,1.4210526315789473
725,2015/2016,Italy Serie A,Chievo Verona,43,45,50.0,38,-2,9,-2,20,9,0.45,2.0,73.85973456368193,1.3157894736842106
726,2015/2016,Italy Serie A,Genoa,45,48,46.0,38,-3,10,-3,20,10,0.5,2.0,74.14015151515153,1.2105263157894737
727,2015/2016,Italy Serie A,Empoli,40,49,46.0,38,-9,11,-9,20,11,0.55,3.0,72.35378832465165,1.2105263157894737
728,2015/2016,Italy Serie A,Torino,52,55,45.0,38,-3,12,-3,20,12,0.6,3.0,76.26283891547052,1.1842105263157894
729,2015/2016,Italy Serie A,Atalanta,41,47,45.0,38,-6,13,-6,20,13,0.65,3.0,73.72922336833821,1.1842105263157894
730,2015/2016,Italy Serie A,Bologna,33,45,42.0,38,-12,14,-12,20,14,0.7,3.0,72.59646946620633,1.105263157894737
731,2015/2016,Italy Serie A,Sampdoria,48,61,40.0,38,-13,15,-13,20,15,0.75,3.0,74.42907268170427,1.0526315789473684
732,2015/2016,Italy Serie A,Udinese,35,60,39.0,38,-25,16,-25,20,16,0.8,4.0,74.97792829180389,1.0263157894736843
733,2015/2016,Italy Serie A,Palermo,38,65,39.0,38,-27,17,-27,20,17,0.85,4.0,72.22186959529577,1.0263157894736843
734,2015/2016,Italy Serie A,Carpi,37,57,38.0,38,-20,18,-20,20,18,0.9,4.0,70.84686138344227,1.0
735,2015/2016,Italy Serie A,Frosinone,35,76,31.0,38,-41,19,-41,20,19,0.95,4.0,68.48465197083618,0.8157894736842105
736,2015/2016,Italy Serie A,Hellas Verona,34,63,28.0,38,-29,20,-29,20,20,1.0,4.0,71.92704532309794,0.7368421052631579
1189,2008/2009,Spain LIGA BBVA,FC Barcelona,105,35,87.0,38,70,1,70,20,1,0.05,1.0,82.98518518518517,2.289473684210526
1190,2008/2009,Spain LIGA BBVA,Real Madrid CF,83,52,78.0,38,31,2,31,20,2,0.1,1.0,82.41868932038835,2.0526315789473686
1191,2008/2009,Spain LIGA BBVA,Sevilla FC,54,39,70.0,38,15,3,15,20,3,0.15,1.0,78.08732057416267,1.8421052631578947
1192,2008/2009,Spain LIGA BBVA,Atlético Madrid,80,57,67.0,38,23,4,23,20,4,0.2,1.0,79.20574162679426,1.763157894736842
1193,2008/2009,Spain LIGA BBVA,Villarreal CF,61,54,65.0,38,7,5,7,20,5,0.25,1.0,78.14267990074443,1.7105263157894737
1194,2008/2009,Spain LIGA BBVA,Valencia CF,68,54,62.0,38,14,6,14,20,6,0.3,2.0,79.17961165048544,1.631578947368421
1195,2008/2009,Spain LIGA BBVA,RC Deportivo de La Coruña,48,47,58.0,38,1,7,1,20,7,0.35,2.0,73.97248803827753,1.5263157894736843
1196,2008/2009,Spain LIGA BBVA,Málaga CF,55,59,55.0,38,-4,8,-4,20,8,0.4,2.0,68.9400479616307,1.4473684210526316
1197,2008/2009,Spain LIGA BBVA,RCD Mallorca,53,60,51.0,38,-7,9,-7,20,9,0.45,2.0,74.89832535885168,1.3421052631578947
1198,2008/2009,Spain LIGA BBVA,RCD Espanyol,46,49,47.0,38,-3,10,-3,20,10,0.5,2.0,73.9356796116505,1.236842105263158
1199,2008/2009,Spain LIGA BBVA,Racing Santander,49,48,46.0,38,1,11,1,20,11,0.55,3.0,73.0108173076923,1.2105263157894737
1200,2008/2009,Spain LIGA BBVA,UD Almería,45,61,46.0,38,-16,12,-16,20,12,0.6,3.0,72.56987951807228,1.2105263157894737
1201,2008/2009,Spain LIGA BBVA,Athletic Club de Bilbao,47,62,44.0,38,-15,13,-15,20,13,0.65,3.0,71.40517241379308,1.1578947368421053
1202,2008/2009,Spain LIGA BBVA,CA Osasuna,41,47,43.0,38,-6,14,-6,20,14,0.7,3.0,69.89242053789732,1.131578947368421
1203,2008/2009,Spain LIGA BBVA,Real Valladolid,46,58,43.0,38,-12,15,-12,20,15,0.75,3.0,73.11363636363636,1.131578947368421
1204,2008/2009,Spain LIGA BBVA,Real Sporting de Gijón,47,79,43.0,38,-32,16,-32,20,16,0.8,4.0,66.54198473282443,1.131578947368421
1205,2008/2009,Spain LIGA BBVA,Getafe CF,50,56,42.0,38,-6,17,-6,20,17,0.85,4.0,75.69437652811736,1.105263157894737
1206,2008/2009,Spain LIGA BBVA,Real Betis Balompié,51,58,42.0,38,-7,18,-7,20,18,0.9,4.0,73.28676470588236,1.105263157894737
1207,2008/2009,Spain LIGA BBVA,CD Numancia,38,69,35.0,38,-31,19,-31,20,19,0.95,4.0,69.85263157894737,0.9210526315789473
1208,2008/2009,Spain LIGA BBVA,RC Recreativo,34,57,33.0,38,-23,20,-23,20,20,1.0,4.0,72.19620253164557,0.868421052631579
1209,2009/2010,Spain LIGA BBVA,FC Barcelona,98,24,99.0,38,74,1,74,20,1,0.05,1.0,83.51838235294119,2.6052631578947367
1210,2009/2010,Spain LIGA BBVA,Real Madrid CF,102,35,96.0,38,67,2,67,20,2,0.1,1.0,83.2775119617225,2.526315789473684
1211,2009/2010,Spain LIGA BBVA,Valencia CF,59,40,71.0,38,19,3,19,20,3,0.15,1.0,79.41586538461539,1.868421052631579
1212,2009/2010,Spain LIGA BBVA,Sevilla FC,65,49,63.0,38,16,4,16,20,4,0.2,1.0,78.73341523341524,1.6578947368421053
1213,2009/2010,Spain LIGA BBVA,RCD Mallorca,59,44,62.0,38,15,5,15,20,5,0.25,1.0,74.64268585131894,1.631578947368421
1214,2009/2010,Spain LIGA BBVA,Getafe CF,58,48,58.0,38,10,6,10,20,6,0.3,2.0,75.37591240875913,1.5263157894736843
1215,2009/2010,Spain LIGA BBVA,Villarreal CF,58,57,56.0,38,1,7,1,20,7,0.35,2.0,78.0956937799043,1.4736842105263157
1216,2009/2010,Spain LIGA BBVA,Athletic Club de Bilbao,50,53,54.0,38,-3,8,-3,20,8,0.4,2.0,74.32409638554219,1.4210526315789473
1217,2009/2010,Spain LIGA BBVA,Atlético Madrid,57,61,47.0,38,-4,9,-4,20,9,0.45,2.0,77.34420289855075,1.236842105263158
1218,2009/2010,Spain LIGA BBVA,RC Deportivo de La Coruña,35,49,47.0,38,-14,10,-14,20,10,0.5,2.0,75.17995169082127,1.236842105263158
1219,2009/2010,Spain LIGA BBVA,RCD Espanyol,29,46,44.0,38,-17,11,-17,20,11,0.55,3.0,72.46200980392156,1.1578947368421053
1220,2009/2010,Spain LIGA BBVA,CA Osasuna,37,46,43.0,38,-9,12,-9,20,12,0.6,3.0,74.40049140049139,1.131578947368421
1221,2009/2010,Spain LIGA BBVA,UD Almería,43,55,42.0,38,-12,13,-12,20,13,0.65,3.0,73.42548076923077,1.105263157894737
1222,2009/2010,Spain LIGA BBVA,Real Zaragoza,46,64,41.0,38,-18,14,-18,20,14,0.7,3.0,73.36790123456791,1.0789473684210527
1223,2009/2010,Spain LIGA BBVA,Real Sporting de Gijón,36,51,40.0,38,-15,15,-15,20,15,0.75,3.0,72.4635922330097,1.0526315789473684
1224,2009/2010,Spain LIGA BBVA,Racing Santander,42,59,39.0,38,-17,16,-17,20,16,0.8,4.0,73.06698564593302,1.0263157894736843
1225,2009/2010,Spain LIGA BBVA,Málaga CF,42,48,37.0,38,-6,17,-6,20,17,0.85,4.0,72.41435768261964,0.9736842105263158
1226,2009/2010,Spain LIGA BBVA,Real Valladolid,37,62,36.0,38,-25,18,-25,20,18,0.9,4.0,73.45673076923076,0.9473684210526315
1227,2009/2010,Spain LIGA BBVA,CD Tenerife,40,74,36.0,38,-34,19,-34,20,19,0.95,4.0,71.81218905472637,0.9473684210526315
1228,2009/2010,Spain LIGA BBVA,Xerez Club Deportivo,38,66,34.0,38,-28,20,-28,20,20,1.0,4.0,70.48604060913705,0.8947368421052632
1229,2010/2011,Spain LIGA BBVA,FC Barcelona,95,21,96.0,38,74,1,74,20,1,0.05,1.0,83.41626794258372,2.526315789473684
1230,2010/2011,Spain LIGA BBVA,Real Madrid CF,102,33,92.0,38,69,2,69,20,2,0.1,1.0,83.50841346153848,2.4210526315789473
1231,2010/2011,Spain LIGA BBVA,Valencia CF,64,44,71.0,38,20,3,20,20,3,0.15,1.0,78.17224880382774,1.868421052631579
1232,2010/2011,Spain LIGA BBVA,Villarreal CF,54,44,62.0,38,10,4,10,20,4,0.2,1.0,78.52870813397132,1.631578947368421
1233,2010/2011,Spain LIGA BBVA,Atlético Madrid,62,53,58.0,38,9,5,9,20,5,0.25,1.0,78.9342105263158,1.5263157894736843
1234,2010/2011,Spain LIGA BBVA,Athletic Club de Bilbao,59,55,58.0,38,4,6,4,20,6,0.3,2.0,76.183014354067,1.5263157894736843
1235,2010/2011,Spain LIGA BBVA,Sevilla FC,62,61,58.0,38,1,7,1,20,7,0.35,2.0,77.55035971223022,1.5263157894736843
1236,2010/2011,Spain LIGA BBVA,RCD Espanyol,46,55,49.0,38,-9,8,-9,20,8,0.4,2.0,73.60885167464116,1.2894736842105263
1237,2010/2011,Spain LIGA BBVA,CA Osasuna,45,46,47.0,38,-1,9,-1,20,9,0.45,2.0,73.68779904306218,1.236842105263158
1238,2010/2011,Spain LIGA BBVA,Real Sporting de Gijón,35,42,47.0,38,-7,10,-7,20,10,0.5,2.0,73.15311004784688,1.236842105263158
1239,2010/2011,Spain LIGA BBVA,Málaga CF,54,68,46.0,38,-14,11,-14,20,11,0.55,3.0,72.81100478468899,1.2105263157894737
1240,2010/2011,Spain LIGA BBVA,Racing Santander,41,56,46.0,38,-15,12,-15,20,12,0.6,3.0,73.37439613526571,1.2105263157894737
1241,2010/2011,Spain LIGA BBVA,Levante UD,41,52,45.0,38,-11,13,-11,20,13,0.65,3.0,71.3272506082725,1.1842105263157894
1242,2010/2011,Spain LIGA BBVA,Real Zaragoza,40,53,45.0,38,-13,14,-13,20,14,0.7,3.0,72.46754807692308,1.1842105263157894
1243,2010/2011,Spain LIGA BBVA,Real Sociedad,49,66,45.0,38,-17,15,-17,20,15,0.75,3.0,73.11244019138753,1.1842105263157894
1244,2010/2011,Spain LIGA BBVA,Getafe CF,49,60,44.0,38,-11,16,-11,20,16,0.8,4.0,74.99880382775122,1.1578947368421053
1245,2010/2011,Spain LIGA BBVA,RCD Mallorca,41,56,44.0,38,-15,17,-15,20,17,0.85,4.0,73.61192214111924,1.1578947368421053
1246,2010/2011,Spain LIGA BBVA,RC Deportivo de La Coruña,31,47,43.0,38,-16,18,-16,20,18,0.9,4.0,74.0287081339713,1.131578947368421
1247,2010/2011,Spain LIGA BBVA,Hércules Club de Fútbol,36,60,35.0,38,-24,19,-24,20,19,0.95,4.0,72.49111675126905,0.9210526315789473
1248,2010/2011,Spain LIGA BBVA,UD Almería,36,70,30.0,38,-34,20,-34,20,20,1.0,4.0,73.67822966507177,0.7894736842105263
1249,2011/2012,Spain LIGA BBVA,Real Madrid CF,121,32,100.0,38,89,1,89,20,1,0.05,1.0,84.71889952153111,2.6315789473684212
1250,2011/2012,Spain LIGA BBVA,FC Barcelona,114,29,91.0,38,85,2,85,20,2,0.1,1.0,84.8983253588517,2.3947368421052633
1251,2011/2012,Spain LIGA BBVA,Valencia CF,59,44,61.0,38,15,3,15,20,3,0.15,1.0,77.56339712918658,1.605263157894737
1252,2011/2012,Spain LIGA BBVA,Málaga CF,54,53,58.0,38,1,4,1,20,4,0.2,1.0,77.0944976076555,1.5263157894736843
1253,2011/2012,Spain LIGA BBVA,Atlético Madrid,53,46,56.0,38,7,5,7,20,5,0.25,1.0,78.4401913875598,1.4736842105263157
1254,2011/2012,Spain LIGA BBVA,Levante UD,54,50,55.0,38,4,6,4,20,6,0.3,2.0,73.01196172248804,1.4473684210526316
1255,2011/2012,Spain LIGA BBVA,CA Osasuna,44,61,54.0,38,-17,7,-17,20,7,0.35,2.0,71.71670702179176,1.4210526315789473
1256,2011/2012,Spain LIGA BBVA,RCD Mallorca,42,46,52.0,38,-4,8,-4,20,8,0.4,2.0,72.46411483253588,1.368421052631579
1257,2011/2012,Spain LIGA BBVA,Sevilla FC,48,47,50.0,38,1,9,1,20,9,0.45,2.0,77.81698564593302,1.3157894736842106
1258,2011/2012,Spain LIGA BBVA,Athletic Club de Bilbao,49,52,49.0,38,-3,10,-3,20,10,0.5,2.0,76.2511961722488,1.2894736842105263
1259,2011/2012,Spain LIGA BBVA,Real Sociedad,46,52,47.0,38,-6,11,-6,20,11,0.55,3.0,72.5657894736842,1.236842105263158
1260,2011/2012,Spain LIGA BBVA,Real Betis Balompié,47,56,47.0,38,-9,12,-9,20,12,0.6,3.0,72.04436450839326,1.236842105263158
1261,2011/2012,Spain LIGA BBVA,Getafe CF,40,51,47.0,38,-11,13,-11,20,13,0.65,3.0,74.04784688995218,1.236842105263158
1262,2011/2012,Spain LIGA BBVA,RCD Espanyol,46,56,46.0,38,-10,14,-10,20,14,0.7,3.0,73.05622009569377,1.2105263157894737
1263,2011/2012,Spain LIGA BBVA,Rayo Vallecano,53,73,43.0,38,-20,15,-20,20,15,0.75,3.0,70.54830917874398,1.131578947368421
1264,2011/2012,Spain LIGA BBVA,Real Zaragoza,36,61,43.0,38,-25,16,-25,20,16,0.8,4.0,72.66507177033493,1.131578947368421
1265,2011/2012,Spain LIGA BBVA,Granada CF,35,56,42.0,38,-21,17,-21,20,17,0.85,4.0,71.6566985645933,1.105263157894737
1266,2011/2012,Spain LIGA BBVA,Villarreal CF,39,53,41.0,38,-14,18,-14,20,18,0.9,4.0,77.41626794258376,1.0789473684210527
1267,2011/2012,Spain LIGA BBVA,Real Sporting de Gijón,42,69,37.0,38,-27,19,-27,20,19,0.95,4.0,72.19036144578313,0.9736842105263158
1268,2011/2012,Spain LIGA BBVA,Racing Santander,28,63,27.0,38,-35,20,-35,20,20,1.0,4.0,70.34299516908212,0.7105263157894737
1269,2012/2013,Spain LIGA BBVA,FC Barcelona,115,40,100.0,38,75,1,75,20,1,0.05,1.0,84.36979949874687,2.6315789473684212
1270,2012/2013,Spain LIGA BBVA,Real Madrid CF,103,42,85.0,38,61,2,61,20,2,0.1,1.0,83.60708304853041,2.236842105263158
1271,2012/2013,Spain LIGA BBVA,Atlético Madrid,65,31,76.0,38,34,3,34,20,3,0.15,1.0,80.5218614718615,2.0
1272,2012/2013,Spain LIGA BBVA,Real Sociedad,70,49,66.0,38,21,4,21,20,4,0.2,1.0,74.77910685805422,1.736842105263158
1273,2012/2013,Spain LIGA BBVA,Valencia CF,67,54,65.0,38,13,5,13,20,5,0.25,1.0,79.03895534290271,1.7105263157894737
1274,2012/2013,Spain LIGA BBVA,Málaga CF,53,50,57.0,38,3,6,3,20,6,0.3,2.0,77.60631692868536,1.5
1275,2012/2013,Spain LIGA BBVA,Real Betis Balompié,57,56,56.0,38,1,7,1,20,7,0.35,2.0,73.9726475279107,1.4736842105263157
1276,2012/2013,Spain LIGA BBVA,Rayo Vallecano,50,66,53.0,38,-16,8,-16,20,8,0.4,2.0,73.04728867623602,1.394736842105263
1277,2012/2013,Spain LIGA BBVA,Sevilla FC,58,54,50.0,38,4,9,4,20,9,0.45,2.0,76.96770904534063,1.3157894736842106
1278,2012/2013,Spain LIGA BBVA,Getafe CF,43,57,47.0,38,-14,10,-14,20,10,0.5,2.0,74.4195374800638,1.236842105263158
1279,2012/2013,Spain LIGA BBVA,Levante UD,40,57,46.0,38,-17,11,-17,20,11,0.55,3.0,74.11010955418851,1.2105263157894737
1280,2012/2013,Spain LIGA BBVA,Athletic Club de Bilbao,44,65,45.0,38,-21,12,-21,20,12,0.6,3.0,75.89430963773067,1.1842105263157894
1281,2012/2013,Spain LIGA BBVA,RCD Espanyol,43,52,44.0,38,-9,13,-9,20,13,0.65,3.0,73.67292663476873,1.1578947368421053
1282,2012/2013,Spain LIGA BBVA,Real Valladolid,49,58,43.0,38,-9,14,-9,20,14,0.7,3.0,72.73096377306902,1.131578947368421
1283,2012/2013,Spain LIGA BBVA,Granada CF,37,54,42.0,38,-17,15,-17,20,15,0.75,3.0,72.6670967190704,1.105263157894737
1284,2012/2013,Spain LIGA BBVA,CA Osasuna,33,50,39.0,38,-17,16,-17,20,16,0.8,4.0,72.6196001367054,1.0263157894736843
1285,2012/2013,Spain LIGA BBVA,RC Celta de Vigo,37,52,37.0,38,-15,17,-15,20,17,0.85,4.0,72.47878787878787,0.9736842105263158
1286,2012/2013,Spain LIGA BBVA,RCD Mallorca,43,72,36.0,38,-29,18,-29,20,18,0.9,4.0,72.7767543859649,0.9473684210526315
1287,2012/2013,Spain LIGA BBVA,RC Deportivo de La Coruña,47,70,35.0,38,-23,19,-23,20,19,0.95,4.0,73.01674641148325,0.9210526315789473
1288,2012/2013,Spain LIGA BBVA,Real Zaragoza,37,62,34.0,38,-25,20,-25,20,20,1.0,4.0,72.79812507312508,0.8947368421052632
1289,2013/2014,Spain LIGA BBVA,Atlético Madrid,77,26,90.0,38,51,1,51,20,1,0.05,1.0,81.1889154704944,2.3684210526315788
1290,2013/2014,Spain LIGA BBVA,FC Barcelona,100,33,87.0,38,67,2,67,20,2,0.1,1.0,84.03309409888357,2.289473684210526
1291,2013/2014,Spain LIGA BBVA,Real Madrid CF,104,38,87.0,38,66,3,66,20,3,0.15,1.0,83.6877990430622,2.289473684210526
1292,2013/2014,Spain LIGA BBVA,Athletic Club de Bilbao,66,39,70.0,38,27,4,27,20,4,0.2,1.0,76.05901116427434,1.8421052631578947
1293,2013/2014,Spain LIGA BBVA,Sevilla FC,69,52,63.0,38,17,5,17,20,5,0.25,1.0,75.23322510822511,1.6578947368421053
1294,2013/2014,Spain LIGA BBVA,Villarreal CF,60,44,59.0,38,16,6,16,20,6,0.3,2.0,73.1445773524721,1.5526315789473684
1295,2013/2014,Spain LIGA BBVA,Real Sociedad,62,55,59.0,38,7,7,7,20,7,0.35,2.0,76.86387559808614,1.5526315789473684
1296,2013/2014,Spain LIGA BBVA,Valencia CF,51,53,49.0,38,-2,8,-2,20,8,0.4,2.0,76.50439528573499,1.2894736842105263
1297,2013/2014,Spain LIGA BBVA,RC Celta de Vigo,49,54,49.0,38,-5,9,-5,20,9,0.45,2.0,72.05994531784005,1.2894736842105263
1298,2013/2014,Spain LIGA BBVA,Levante UD,35,43,48.0,38,-8,10,-8,20,10,0.5,2.0,73.52438876912561,1.263157894736842
1299,2013/2014,Spain LIGA BBVA,Málaga CF,39,46,45.0,38,-7,11,-7,20,11,0.55,3.0,74.18120300751879,1.1842105263157894
1300,2013/2014,Spain LIGA BBVA,Rayo Vallecano,46,80,43.0,38,-34,12,-34,20,12,0.6,3.0,72.4872009569378,1.131578947368421
1301,2013/2014,Spain LIGA BBVA,RCD Espanyol,41,51,42.0,38,-10,13,-10,20,13,0.65,3.0,72.94719753930279,1.105263157894737
1302,2013/2014,Spain LIGA BBVA,Getafe CF,35,54,42.0,38,-19,14,-19,20,14,0.7,3.0,73.27460127591708,1.105263157894737
1303,2013/2014,Spain LIGA BBVA,Granada CF,32,56,41.0,38,-24,15,-24,20,15,0.75,3.0,72.06877022653721,1.0789473684210527
1304,2013/2014,Spain LIGA BBVA,Elche CF,30,50,40.0,38,-20,16,-20,20,16,0.8,4.0,71.74322169059012,1.0526315789473684
1305,2013/2014,Spain LIGA BBVA,UD Almería,43,71,40.0,38,-28,17,-28,20,17,0.85,4.0,69.85224358974358,1.0526315789473684
1306,2013/2014,Spain LIGA BBVA,CA Osasuna,32,62,39.0,38,-30,18,-30,20,18,0.9,4.0,72.26602870813397,1.0263157894736843
1307,2013/2014,Spain LIGA BBVA,Real Valladolid,38,60,36.0,38,-22,19,-22,20,19,0.95,4.0,71.85197368421053,0.9473684210526315
1308,2013/2014,Spain LIGA BBVA,Real Betis Balompié,36,78,25.0,38,-42,20,-42,20,20,1.0,4.0,72.64915603402446,0.6578947368421053
1309,2014/2015,Spain LIGA BBVA,FC Barcelona,110,21,94.0,38,89,1,89,20,1,0.05,1.0,83.7775554588952,2.473684210526316
1310,2014/2015,Spain LIGA BBVA,Real Madrid CF,118,38,92.0,38,80,2,80,20,2,0.1,1.0,84.05980861244021,2.4210526315789473
1311,2014/2015,Spain LIGA BBVA,Atlético Madrid,67,29,78.0,38,38,3,38,20,3,0.15,1.0,80.27785372522216,2.0526315789473686
1312,2014/2015,Spain LIGA BBVA,Valencia CF,70,32,77.0,38,38,4,38,20,4,0.2,1.0,78.52794865952761,2.026315789473684
1313,2014/2015,Spain LIGA BBVA,Sevilla FC,71,45,76.0,38,26,5,26,20,5,0.25,1.0,76.77533606744132,2.0
1314,2014/2015,Spain LIGA BBVA,Villarreal CF,48,37,60.0,38,11,6,11,20,6,0.3,2.0,74.71679197994987,1.5789473684210527
1315,2014/2015,Spain LIGA BBVA,Athletic Club de Bilbao,42,41,55.0,38,1,7,1,20,7,0.35,2.0,77.25847003873321,1.4473684210526316
1316,2014/2015,Spain LIGA BBVA,RC Celta de Vigo,47,44,51.0,38,3,8,3,20,8,0.4,2.0,73.58752997601917,1.3421052631578947
1317,2014/2015,Spain LIGA BBVA,Málaga CF,42,48,50.0,38,-6,9,-6,20,9,0.45,2.0,73.00492329308118,1.3157894736842106
1318,2014/2015,Spain LIGA BBVA,RCD Espanyol,47,51,49.0,38,-4,10,-4,20,10,0.5,2.0,72.63569150148098,1.2894736842105263
1319,2014/2015,Spain LIGA BBVA,Rayo Vallecano,46,68,49.0,38,-22,11,-22,20,11,0.55,3.0,73.74654775604142,1.2894736842105263
1320,2014/2015,Spain LIGA BBVA,Real Sociedad,44,51,46.0,38,-7,12,-7,20,12,0.6,3.0,76.01932672590569,1.2105263157894737
1321,2014/2015,Spain LIGA BBVA,Elche CF,35,62,41.0,38,-27,13,-27,20,13,0.65,3.0,72.22272727272728,1.0789473684210527
1322,2014/2015,Spain LIGA BBVA,Getafe CF,33,64,37.0,38,-31,14,-31,20,14,0.7,3.0,71.76642628205127,0.9736842105263158
1323,2014/2015,Spain LIGA BBVA,Levante UD,34,67,37.0,38,-33,15,-33,20,15,0.75,3.0,72.17397671440733,0.9736842105263158
1324,2014/2015,Spain LIGA BBVA,SD Eibar,34,55,35.0,38,-21,16,-21,20,16,0.8,4.0,71.2642543859649,0.9210526315789473
1325,2014/2015,Spain LIGA BBVA,RC Deportivo de La Coruña,35,60,35.0,38,-25,17,-25,20,17,0.85,4.0,72.13125634333768,0.9210526315789473
1326,2014/2015,Spain LIGA BBVA,Granada CF,29,64,35.0,38,-35,18,-35,20,18,0.9,4.0,72.1992691561037,0.9210526315789473
1327,2014/2015,Spain LIGA BBVA,UD Almería,35,64,32.0,38,-29,19,-29,20,19,0.95,4.0,71.10007974481661,0.8421052631578947
1328,2014/2015,Spain LIGA BBVA,Córdoba CF,22,68,20.0,38,-46,20,-46,20,20,1.0,4.0,69.95397584871272,0.5263157894736842
1329,2015/2016,Spain LIGA BBVA,FC Barcelona,112,29,91.0,38,83,1,83,20,1,0.05,1.0,85.00886306675781,2.3947368421052633
1330,2015/2016,Spain LIGA BBVA,Real Madrid CF,110,34,90.0,38,76,2,76,20,2,0.1,1.0,83.90112781954889,2.3684210526315788
1331,2015/2016,Spain LIGA BBVA,Atlético Madrid,63,18,88.0,38,45,3,45,20,3,0.15,1.0,80.62608846496406,2.3157894736842106
1332,2015/2016,Spain LIGA BBVA,Villarreal CF,44,35,64.0,38,9,4,9,20,4,0.2,1.0,77.70875579099263,1.6842105263157894
1333,2015/2016,Spain LIGA BBVA,Athletic Club de Bilbao,58,45,62.0,38,13,5,13,20,5,0.25,1.0,78.34363180678969,1.631578947368421
1334,2015/2016,Spain LIGA BBVA,RC Celta de Vigo,51,59,60.0,38,-8,6,-8,20,6,0.3,2.0,76.36572075672795,1.5789473684210527
1335,2015/2016,Spain LIGA BBVA,Sevilla FC,51,50,52.0,38,1,7,1,20,7,0.35,2.0,78.20071371474252,1.368421052631579
1336,2015/2016,Spain LIGA BBVA,Málaga CF,38,35,48.0,38,3,8,3,20,8,0.4,2.0,75.23484848484848,1.263157894736842
1337,2015/2016,Spain LIGA BBVA,Real Sociedad,45,48,48.0,38,-3,9,-3,20,9,0.45,2.0,76.03456747930434,1.263157894736842
1338,2015/2016,Spain LIGA BBVA,Real Betis Balompié,34,52,45.0,38,-18,10,-18,20,10,0.5,2.0,74.50229551150603,1.1842105263157894
1339,2015/2016,Spain LIGA BBVA,Valencia CF,46,48,44.0,38,-2,11,-2,20,11,0.55,3.0,78.69717475506951,1.1578947368421053
1340,2015/2016,Spain LIGA BBVA,UD Las Palmas,45,53,44.0,38,-8,12,-8,20,12,0.6,3.0,71.79584611720534,1.1578947368421053
1341,2015/2016,Spain LIGA BBVA,SD Eibar,49,61,43.0,38,-12,13,-12,20,13,0.65,3.0,72.27923976608189,1.131578947368421
1342,2015/2016,Spain LIGA BBVA,RCD Espanyol,40,74,43.0,38,-34,14,-34,20,14,0.7,3.0,73.77558373590983,1.131578947368421
1343,2015/2016,Spain LIGA BBVA,RC Deportivo de La Coruña,45,61,42.0,38,-16,15,-16,20,15,0.75,3.0,74.96764457631683,1.105263157894737
1344,2015/2016,Spain LIGA BBVA,Real Sporting de Gijón,40,62,39.0,38,-22,16,-22,20,16,0.8,4.0,73.36903981903983,1.0263157894736843
1345,2015/2016,Spain LIGA BBVA,Granada CF,46,69,39.0,38,-23,17,-23,20,17,0.85,4.0,73.47290385053543,1.0263157894736843
1346,2015/2016,Spain LIGA BBVA,Rayo Vallecano,52,73,38.0,38,-21,18,-21,20,18,0.9,4.0,74.38009259259258,1.0
1347,2015/2016,Spain LIGA BBVA,Getafe CF,37,67,36.0,38,-30,19,-30,20,19,0.95,4.0,74.51727346278318,0.9473684210526315
1348,2015/2016,Spain LIGA BBVA,Levante UD,37,70,32.0,38,-33,20,-33,20,20,1.0,4.0,74.0886335156072,0.8421052631578947
